Index of Urantia Foundation's News Online articles	Index des articles en ligne des Nouvelles de la Fondation Urantia
Volume 1, 2007	Volume 1, 2007
Volume 1, Issue 1, May 2007	Volume 1, numéro 1, mai 2007
Welcome & Contact Details	Bienvenue et coordonnées
Welcome	Bienvenue
Newsworthy Items From The April 2007 Trustees Meeting	Articles dignes d'intérêt de la réunion du conseil d'administration d'avril 2007
The Urantia Book In India	Le Livre d'Urantia en Inde
Urantia Foundation Staff: Jay Peregrine	Personnel de la Fondation Urantia : Jay Peregrine
Volume 1, Issue 2, Sept. 2007	Volume 1, numéro 2, septembre 2007
Welcome & Contact Details	Bienvenue et coordonnées
Even as I have loved you	Même si je t'ai aimé
Newsworthy Items From The August, 2007 Trustee Meeting	Articles dignes d'intérêt de la réunion des administrateurs d'août 2007
Foundation Prints A Portuguese Translation	La Fondation imprime une traduction en portugais
An Educational Initiative	Une initiative éducative
Distribution: El Libro De Urantia	Distribution : El Libro De Urantia
A Short History Of The Owners Of Urantia Foundation's Head Office	Une brève histoire des propriétaires du siège social de la Fondation Urantia
Comments On Urantia Online	Commentaires sur Urantia Online
Trustee Emerita Patricia Mundelius Leaves Expanded Board	L'administratrice émérite Patricia Mundelius quitte le conseil d'administration élargi
Reflections	Réflexions
Help Wanted	Aide recherchée
Volume 1, Issue 3, Dec. 2007	Volume 1, numéro 3, décembre 2007
Welcome & Contact Details	Bienvenue et coordonnées
Tension — the Prerequisite of Growth	La tension, condition préalable à la croissance
Urantia Foundation Launches Matching Fundraising Campaign In December, 2007	La Fondation Urantia lance une campagne de collecte de fonds de contrepartie en décembre 2007
Newsworthy Decisions From Urantia Foundation's October Trustees Meeting	Décisions dignes d'intérêt de la réunion des administrateurs de la Fondation Urantia en octobre
German Translation Brings Readers Together	La traduction allemande rassemble les lecteurs
Neal Waldrop Concludes Four Years of Active Participation	Neal Waldrop conclut quatre années de participation active
Millennial Reflections	Réflexions millénaires
Seeding the Revelation in South Africa	Semer la révélation en Afrique du Sud
Volume 2, 2008	Volume 2, 2008
Volume 2, Issue 1, March 2008	Volume 2, numéro 1, mars 2008
Welcome & Contact Details	Bienvenue et coordonnées
The Secret of a Better Civilisation	Le secret d'une meilleure civilisation
O Livro de Urântia Premiered in Brazil	O Livro de Urântia Première au Brésil
Newsworthy Decisions From Urantia Foundation's January 2008 Trustees Meeting	Décisions dignes d'intérêt de Réunion des administrateurs de la Fondation Urantia de janvier 2008
Japanese Translation Continues To Progress	La traduction japonaise continue de progresser
In Memorium: Karlheinz Stockhausen	In Memorium : Karlheinz Stockhausen
Study Groups: The Principle Of Sharing	Groupes d'étude : Le principe du partage
Reflections on introducing The Urantia Book	des réflexions sur l'introduction du Livre d'Urantia
Testimonials About The Urantia Book	Témoignages sur le Livre d'Urantia
Two new Trustees elected	Deux nouveaux administrateurs élus
Volume 2, Issue 2, June 2008	Volume 2, numéro 2, juin 2008
Welcome & Contact Details	Bienvenue et coordonnées
The Revelation Enters the 21st Century	La Révélation entre dans le 21e siècle
Noteworthy Decisions From The April 2008 Board Meeting In Paris	Décisions remarquables de la réunion du Conseil d'administration d'avril 2008 à Paris
Buenos Aires Book Fair	Foire du livre de Buenos Aires
The Urantia Community Endowment: A Fund For The Future	La Fondation de la Communauté Urantia : Un fonds pour l'avenir
Duane Faw: Honoring a Man Who Served the Revelation	Duane Faw : Honorer un homme qui a servi la Révélation
Volume 2, Issue 3, Sept. 2008	Volume 2, numéro 3, septembre 2008
Welcome & Contact Details	Bienvenue & Coordonnées
Seppo Kanerva announces his Retirement	Seppo Kanerva annonce sa retraite
The Future of the Urantia Movement	L'avenir du Mouvement Urantia
Newsworthy Decisions Made By Urantia Foundation's Board Of Trustees	Décisions dignes d'intérêt prises par le conseil d'administration de la Fondation Urantia
Printing Of El Libro De Urantia European Edition	Impression du Livre d'Urantia Édition européenne
A Tribute to Pat Mundelius	Un hommage à Pat Mundelius
Why Is The Urantia Book Religious But Not a Religion?	Pourquoi le Livre d'Urantia est-il religieux mais pas une religion ?
Are You a New Religion or a Cult?	Êtes-vous une nouvelle religion ou une secte ?
UBIS... Celebrating 10 Years of Dedicated Service To The Urantia Book Community	UBIS... célèbre 10 ans de service dévoué à la communauté du Livre d'Urantia
Volume 2, Issue 4, Dec. 2008	Volume 2, Numéro 4, décembre 2008
Welcome & Contact Details	Bienvenue et coordonnées
Holiday Greetings From Urantia Foundation	Bienvenue et coordonnées
Urantia Foundation Launches Matching Fund-Raising Campaign 2008	Salutations de Noël de la Fondation Urantia
Noteworthy Decisions From The November 2008 Board Meeting	La Fondation Urantia lance une campagne de collecte de fonds de contrepartie 2008
The Urantia Book In Austria	Décisions remarquables de la réunion du conseil d'administration de novembre 2008
Education And Urantia Foundation	Le Livre d'Urantia en Autriche
Second Meeting of Urantia Book Readers In Germany	L'éducation et la Fondation Urantia
Henk Mylanus, New Associate Trustee And European Manager Of Sales	Deuxième réunion des lecteurs du Livre d'Urantia en Allemagne
Reflections	Henk Mylanus, nouvel administrateur associé et directeur européen des ventes
Volume 3, 2009	Réflexions
Volume 3, Issue 1, March 2009	Volume 3, 2009
Welcome & Contact Details	Volume 3, Numéro 1, Mars 2009
Kind and Generous Souls	Bienvenue et coordonnées
Noteworthy Decisions From The January 2009 Board Meeting	Âmes aimables et généreuses
A Vision of the Future	Décisions remarquables de la réunion du Conseil d'administration de janvier 2009
The History of the Polish Translation	Une vision du futur
Standard Reference Text Commiffee Report	L'histoire de la traduction polonaise
Millennial Reflections	Texte de référence standard Rapport du comité
The Urantia Book Index Project	Réflexions millénaires
UBIS is Hot!	Le Livre d'Urantia Le projet d'indexation
Holiday Party At 533 Diversersey	UBIS est chaud !
Volume 3, Issue 2, June 2009	Fête de Noël au 533 Diversersey
Welcome & Contact Details	Volume 3, numéro 2, juin 2009
Gratitude To Those Who Serve The Revelation	Bienvenue et coordonnées
Pre-Conference Leadership Roundtable	Gratitude à ceux qui servent la Révélation
Noteworthy Decisions From The April 2009 Board Meeting	Table ronde sur le leadership avant la conférence
God Consciousness — A Living University	Décisions remarquables de la réunion du conseil d'administration d'avril 2009
Update From The Urantia Book Internet School (UBIS)	La conscience divine — Une mise à jour de l'université vivante
Looking For A French Distributor	de l'école Internet du Livre d'Urantia (UBIS)
The Urantia Book And Christianity	À la recherche d'un distributeur français
Printing of El Libro De Urantia European Edition	Le Livre d'Urantia et le christianisme
The Second Mile As A Community Experience	Impression du Livre d'Urantia Édition européenne
Reflections — Where Gaps Were Bridged	Le deuxième kilomètre comme expérience communautaire
Volume 3, Issue 3, Sept. 2009	Réflexions — Là où les lacunes ont été comblées
Welcome & Contact Details	Volume 3, numéro 3, septembre 2009
The Road Ahead	Bienvenue et coordonnées
Parliament of the World's Religions 2009	La route à suivre
Noteworthy Decisions from the July 2009 Board Meeting	Parlement des religions du monde 2009
The History of the Hungarian (Magyar) Translation	Décisions remarquables de la réunion du conseil d'administration de juillet 2009
Interest in the Chinese Translation	L'histoire de la traduction hongroise (magyar)
The Second Mile In Retrospect: Thoughts On The Boulder Experiment	L'intérêt pour la traduction chinoise
Reflections on 533 Diversey	Le deuxième jalon rétrospectif : réflexions sur l'expérience Boulder
El Libro De Urantia — European Edition	Réflexions sur 533 Diversey
Quebec Office Closed	El Libro De Urantia — Édition européenne
God Consciousness: A Living University Inspires In-Depth Study	Bureau du Québec fermé
A Poem for Bert Cobb	Conscience de Dieu : Une université vivante inspire une étude approfondie
Volume 3, Issue 4, Dec. 2009	Un poème pour Bert Cobb
Welcome & Contact Details	Volume 3, Numéro 4, décembre 2009
Urantia Foundation Launches Matching Fund-Raising Campaign 2009	Bienvenue et coordonnées
Jesus and Ganid	La Fondation Urantia lance une campagne de collecte de fonds de contrepartie 2009
Noteworthy Decisions From The October 2009 Board Meeting	Jésus et Ganid
Library Placement	Décisions remarquables d'octobre 2009 Réunion du conseil d'administration
When Great Britain Meets Little Brittany	Placement en bibliothèque
The Pipeline of Light	Quand la Grande-Bretagne rencontre la Petite Bretagne
The French Audio Version of Le Livre d'Urantia	Le pipeline de lumière
Das Urantia Buch in Munich	La version audio française du Livre d'Urantia
Meeting of the IT Minds	Das Urantia Buch à Munich
Volume 4, 2010	Réunion des esprits informatiques
Volume 4, Issue 1, March 2010	Volume 4, 2010
Welcome & Contact Details	Volume 4, numéro 1, mars 2010
Reflections on 2009 and a Look into the Future	Réflexions sur 2009 et un regard sur l'avenir
Sweden and The Urantia Book	de la Suède et le
Parliament of The World's Religions	Parlement du Livre d'Urantia des religions du monde Une
Unexpected Joy	joie inattendue
A Gathering In Mexico City	Un rassemblement à Mexico
Our Trip To Mexico City	Notre voyage à Mexico
Orlando Florida: Another Chapter Unfolds	Orlando Floride : un autre chapitre se déroule
Volume 4, Issue 2, June 2010	Volume 4, numéro 2, juin 2010
Welcome & Contact Details	Bienvenue et coordonnées
1,000 Libraries, 1,000 Book Reviews, and 1,000 Study Groups	1 000 bibliothèques, 1 000 critiques de livres et 1 000 groupes d'étude
Noteworthy Decisions from the April 2010 Board Meeting	Décisions remarquables de la réunion du Conseil d'administration d'avril 2010
UBIS News: A New Website, an Expanded Curriculum, and the Challenge Ahead	Actualités UBIS : Un nouveau site Web, un programme d'études élargi et le défi à venir
Introducing the Urantia Book Historical Society	Présentation de la Société historique du livre d'Urantia
Attending the Book Fair in Budapest, Hungary	Participation à la Foire du livre de Budapest, Hongrie
9th National Meeting Of Readers In Spain — Cultivating Universal Intelligence	9e réunion nationale des lecteurs en Espagne — Cultiver l'intelligence universelle
Nola Smith: A Pioneer in Launching the Urantia Revelation	Nola Smith : Un pionnier dans le lancement de la Révélation Urantia
Volume 4, Issue 3, Sept. 2010	Volume 4, numéro 3, septembre 2010
Welcome & Contact Details	Bienvenue et coordonnées
President's Report	Rapport du président
Noteworthy Decisions from the July 2010 Board Meeting	Décisions remarquables de la réunion du conseil d'administration de juillet 2010
Dorothy Elder Passes the UBIS Leadership Torch	Dorothy Elder passe le flambeau du leadership d'UBIS
Appreciative Inquiry for Study Groups	Enquête appréciative pour les groupes d'étude
Study Groups: New Thoughts from an Old Reader	Groupes d'étude : nouvelles pensées d'un Ancien lecteur
A Follow Up to Placing Urantia Books in Alternative Libraries	Une suite au placement des livres d'Urantia dans des bibliothèques alternatives
Comments from Readers of The Urantia Book	Commentaires des lecteurs du Livre d'Urantia
Volume 4, Issue 4, Dec. 2010	Volume 4, Numéro 4, décembre 2010
Welcome & Contact Details	Bienvenue et coordonnées
The Art of Translations	L'art des traductions
Receiving Az Urantia könyv, the Magyar (Hungarian) Translation of The Urantia Book	Recevoir Az Urantia könyv, la traduction magyar (hongroise) de L'Urantia Livre
El Libro De Urantia Edición Europea — The Spanish European Edition	El Libro De Urantia Edición Europea — L'édition européenne espagnole
Urantiaboken — the Swedish Translation	Urantiaboken — la traduction suédoise
O Livro de Urântia — the Portuguese Translation	O Livro de Urântia — la traduction portugaise
Księga Urantii: The Polish Translation Has Reached the Readers	Księga Urantii : La traduction polonaise a atteint les lecteurs
Das Urantia Buch — the German Translation	Das Urantia Buch — la traduction allemande
The Story Of Urantia Raamat — The Estonian Translation	L'histoire d'Urantia Raamat — l'estonien Traduction
Книга Урантии — the Russian Translation	Книга Урантии — la traduction russe
“Go Into All the World” — Jesus	« Allez dans le monde entier » — Jésus
Volume 5, 2011	Volume 5, 2011
Volume 5, Issue 1, March 2011	Volume 5, Numéro 1, mars 2011
Welcome & Contact Details	Bienvenue et coordonnées
The Age of Wonder	L'Âge des Merveilles
Noteworthy Decisions from the January 2011 Board of Trustees Meeting	Décisions remarquables de la réunion du conseil d'administration de janvier 2011
The Education Initiative	L'Initiative éducative
A Short History of the French Translation	A Bref historique de la
Second Society Foundation and A Study of the Master Universe	Fondation de la Seconde Société de Traduction Française et une étude du Maître Univers
The Trustees Meet in the Lone Star State	Les administrateurs se réunissent dans l'État de l'Étoile Solitaire
Comments from Readers of The Urantia Book	Commentaires des lecteurs du Livre d'Urantia
Volume 5, Issue 2, June 2011	Volume 5, numéro 2, juin 2011
Welcome & Contact Details	Bienvenue et coordonnées
Why Study Groups Matter to the Future of the World	Pourquoi les groupes d'étude sont importants pour l'avenir du monde
Noteworthy Goals from the April 2011 Board of Trustees Meeting	Objectifs remarquables de la réunion du conseil d'administration d'avril 2011
Jay Peregrine visits Finland	Jay Peregrine visite la Finlande
The Spanish Revision Project	Le projet de révision en espagnol
The Urantia Book Internet School — My Lifeline to the Urantia Book Community	L'école Internet du Livre d'Urantia — Ma bouée de sauvetage pour la communauté du livre d'Urantia
The Debut of The Urantia Book at the 2011 Budapest Book Fair	Les débuts du Livre d'Urantia à la Foire du livre de Budapest 2011
Comments from Readers of The Urantia Book	Commentaires des lecteurs du Livre d'Urantia 
Volume 5, Issue 3, Sept. 2011	Volume 5, Numéro 3, septembre 2011
Welcome & Contact Details	Bienvenue et coordonnées
Report on the Kickoff Meeting for the Revision of the Spanish Translation	Rapport sur la réunion de lancement pour la révision de la traduction espagnole
Noteworthy Goals and Decisions from the July 2011 Board of Trustees Meeting	Objectifs et décisions remarquables de la réunion du conseil d'administration de juillet 2011.
Urantia Book Readers Study Together this Summer	Les lecteurs du Livre d'Urantia étudient ensemble cet été pour
Training Teachers/Facilitators for the Urantia Book Internet School	former
Planned Giving to Urantia Foundation	les enseignants/animateurs de l'École Internet du Livre d'Urantia. à la Fondation Urantia
Report from the Pipeline of Light 2003-2011	Rapport du Pipeline de Lumière 2003-2011
A Reader's Experience Staying at 533 W Diversey Parkway	Expérience d'un lecteur séjournant au 533 W Diversey Parkway
Comments from Readers	Commentaires des lecteurs
Volume 5, Issue 4, Dec. 2011	Volume 5, numéro 4, décembre 2011
Welcome & Contact Details	Bienvenue et coordonnées
A Season of Gratitude and a Time for Generosity	Une saison de gratitude et un temps de générosité
Noteworthy Decisions from the October 2011 Board of Trustees Meeting	Des décisions remarquables de la Réunion du Conseil d'administration d'octobre 2011 Démarrage
Fast Start for Urantia Book Study Group Portal — Tri-Partisan Support Team Formed	rapide pour le portail du groupe d'étude du Livre d'Urantia — Formation d'une équipe de soutien tripartite
The Rewards of Being a Teacher/Facilitator for UBIS	Les récompenses d'être un enseignant/facilitateur pour l'UBIS
Report on the Kickooff Meeting for the Revision of the Portuguese Translation	Rapport sur la réunion de lancement pour la révision de la traduction portugaise
Das Urantia Buch Presented at the Book Fair in Rasatt, Germany	Das Urantia Buch présenté au Livre Foire à Rasatt, Allemagne
The Siegels Visit Sweden, Estonia, Russia, and Finland in June, 2011	Les Siegel visitent la Suède, l'Estonie, la Russie et la Finlande en juin 2011
Centering Prayer Retreat in Brittany, France	Retraite de prière de centrage en Bretagne, France
A New Associate Trustee Is Appointed	Un nouvel administrateur associé est nommé
Comments from Readers	Commentaires des lecteurs
Volume 6, 2012	Volume 6, 2012
Volume 6, Issue 1, March 2012	Volume 6, numéro 1, mars 2012
Welcome & Contact Details	Bienvenue et Coordonnées
Our Journey to South America	Notre voyage en Amérique du Sud
Noteworthy Decisions from the January 2012 Board of Trustees Meeting	Décisions remarquables de la réunion du conseil d'administration de janvier 2012
Teacher-Facilifators Needed for the Urantia Book Internet School	Enseignants-animateurs nécessaires pour l'école Internet du Livre d'Urantia
The Urantia Book around the world	Le Livre d'Urantia à travers le monde
Comments from Readers of The Urantia Book	Commentaires des lecteurs du Livre d'Urantia
Volume 6, Issue 2, June 2012	Volume 6, numéro 2, juin 2012
Welcome & Contact Details	Bienvenue et Coordonnées
Worship and Wisdom at 533 W Diversey Parkway	Culte et sagesse au 533 W Diversey Parkway
Noteworthy Decisions from the April 2012 Board of Trustees Meeting	Décisions remarquables de la réunion du Conseil d'administration d'avril 2012
The Hebrew Translation of The Urantia Book	La traduction hébraïque du Livre d'Urantia
Reflections on the 11th meeting of Urantia Book readers in Spain	Réflexions sur la 11e réunion des lecteurs du Livre d'Urantia en Espagne
A Meredith Sprunger Story	Une histoire de Meredith Sprunger
How I found The Urantia Book	Comment j'ai trouvé le Livre d'Urantia
Help Wanted for Translations	Aide recherchée pour les traductions
My trip to Colombia, South America	Mon voyage en Colombie, Amérique du Sud
Urantia Book Study Group Directory	Annuaire du Groupe d'étude du Livre d'Urantia
Two New Appointments	Deux nouvelles nominations
Reader Comments	Commentaires des lecteurs
Irmeli Ivalo-Sjölie: Book Ambassador at Large	Irmeli Ivalo-Sjölie : Ambassadrice itinérante du Livre
Volume 6, Issue 3, Aug. 2012	Volume 6, Numéro 3, Août 2012
Welcome & Contact Details	Bienvenue et coordonnées
Pulling Together for the Common Good	Rassembler pour le bien commun
Noteworthy Decisions from the July 2012 Board of Trustees Meeting	Décisions remarquables de la réunion du conseil d'administration de juillet 2012
The Urantia Book and its teachings in Babasa Indonesia	Le Livre d'Urantia et ses enseignements en babasa indonésien
Spanish UBIS—One More Step in the Expansion of the Urantia Book Internet School	espagnol UBIS—Une étape de plus dans l'expansion de l'école Internet du Livre d'Urantia
The Evolution of Translations	L'évolution des traductions
A Timeline for The Urantia Book	Une chronologie pour le Livre d'Urantia
Five Days at 533 W Diversey Parkway	Cinq jours au 533 W Diversey Parkway
A Summer Urantia Book Conference in Berlin	Une conférence d'été du Livre d'Urantia à Berlin 
Remembering Mary Lou Hales	en souvenir de Mary Lou Hales
Remembering Werner Sutter	en souvenir de Werner Sutter
Volunteers Needed	Bénévoles recherchés
Comments from readers	Commentaires des lecteurs
Volume 6, Issue 4, Nov. 2012	Volume 6, numéro 4, novembre 2012
Welcome & Contact Details	Bienvenue et coordonnées Réunion
Joint Meeting of The Urantia Book Fellowship and Urantia Foundation	conjointe de la Bourse du Livre d'Urantia et de la Fondation Urantia
Winter Fundraising Match of $160,000 Launches Now	La collecte de fonds hivernale de 160 000 $ est lancée maintenant
An Audio Version of The Urantia Book in Portuguese	Une version audio du Livre d'Urantia en portugais
Engineering the Audio _O Livro de Urântia_	Ingénierie de l'audio _O Livro de Urântia_
Noteworthy Decisions from the October 2012 Board of Trustees Meeting	Décisions remarquables de la réunion du Conseil d'administration d'octobre 2012
A Community Introduction to The Urantia Book	Une introduction communautaire au Livre d'Urantia
A Seminar on the Truths of Spiritual Experience	Un séminaire sur les vérités de l'expérience spirituelle
The Number of Urantia Books Printed between 1955 and 2012	Le nombre de livres d'Urantia imprimés entre 1955 et 2012
The Third Urantia Book Information Technology (IT) Roundtable	Le troisième Livre d'Urantia Table ronde sur les technologies de l'information (TI)
Impressions of the Information Technology Roundtable	Impressions de la table ronde sur les technologies de l'information
Reader Comments	Commentaires des lecteurs
Urantia Book Holiday Sale	Vente de vacances du Livre d'Urantia
Volume 7, 2013	Volume 7, 2013
Volume 7, Issue 1, March 2013	Volume 7, numéro 1, mars 2013
Welcome & Contact Details	Bienvenue et coordonnées
Urantia Foundation Announces New Book Covers For The Urantia Book	La Fondation Urantia annonce de nouvelles couvertures de livres pour le Livre d'Urantia
Noteworthy Decisions from the January 2013 Board of Trustees Meeting	Décisions remarquables de janvier 2013 Réunion du Conseil d'administration
The 2012 Survey of Readers of The Urantia Book	L'enquête 2012 auprès des lecteurs du Livre d'Urantia
Finding a Distributor in Hungary for the Hungarian translation, Az Urantia könyv	Trouver un distributeur en Hongrie pour la traduction hongroise, Az Urantia könyv
Around the World with Urantia Book. Ambassador Irmeli Ivalo-Sjölie	Autour du monde avec le Livre d'Urantia. Ambassadrice Irmeli Ivalo-Sjölie
How the Idea for a Urantia Book Translation Tool was Born	Comment est née l'idée d'un outil de traduction du Livre d'Urantia
A Group Meditation at Urantia Foundation	Une méditation de groupe à la Fondation Urantia
Half Price Books-an Opportunity for Urantia Book Dissemination	Des livres à moitié prix - une opportunité pour la diffusion du Livre d'Urantia
A Thank You Note from Chile	Une note de remerciement du Chili Annonces de
A Reader's Comment	commentaires
Announcements	d'un lecteur
Volume 7, Issue 2, June 2013	Volume 7, numéro 2, juin 2013
Welcome & Contact Details	Bienvenue et coordonnées
New Planned Giving Website at Urantia.org	Nouveau site Web de dons planifiés sur Urantia.org
Notewortby Decisions from the April 2013 Board of Trustees Meeting	Note des décisions de la réunion du Conseil d'administration d'avril 2013
A Decimal Seminar	Un séminaire décimal
The Urantia Book in Spain	Le Livre d'Urantia en Espagne
Translating The Urantia Book Into Farsi: The Inspiring Story Of How This Project Began	Traduire le Livre d'Urantia en farsi : L'histoire inspirante de la façon dont ce projet a commencé
Inspire and Be Inspired	Inspirer et être inspiré
The Third Meeting of the Blue Club in Frankfurt, Germany	Le Troisième réunion du Blue Club à Francfort, Allemagne
A New Platform for The Urantia Book Internet School	Une nouvelle plateforme pour l'École Internet du Livre d'Urantia
A Reader's Comment	Un commentaire d'un lecteur
Volume 7, Issue 3, Sept. 2013	Volume 7, numéro 3, septembre 2013
Welcome & Contact Details	Bienvenue et coordonnées
Smart Religion	Smart Religion
Noteworthy Decisions from the July 2013 Board of Trustees Meeting	Décisions remarquables de la réunion du conseil d'administration de juillet 2013
What the Women are Planning	Ce que les femmes planifient
The Urantia Book Study Group Directory	L'annuaire du groupe d'étude du Livre d'Urantia
One Student's Perspective on UBIS	Le point de vue d'un étudiant sur UBIS
A Tale of Two Conferences	Un récit de deux conférences
Urantia Book. Ambassador Irmeli Ivalo-Sjölie visits Finland, and the USA	Le Livre d'Urantia. L'Ambassadeur Irmeli Ivalo-Sjölie visite la Finlande et les États-Unis
The Urantia Book in Korea	Le Livre d'Urantia en Corée
A Reader's Comment	Commentaire d'un lecteur
Help Wanted	Aide recherchée
Volume 7, Issue 4, Dec. 2013	Volume 7, Numéro 4, décembre 2013
Welcome & Contact Details	Bienvenue et coordonnées 
Matthew the Money-getter	Matthieu le chercheur d'argent
Noteworthy Decisions from the October 2013 Board of Trustees Meeting	Décisions remarquables de la réunion du Conseil d'administration d'octobre 2013
Urantia Books En Route to the Philippines	Les Livres d'Urantia en route vers les Philippines L'
A Filmmaker's Approach to Promoting The Urantia Book	approche d'un cinéaste pour promouvoir le Livre d'Urantia
The Urantia Book Study Group Directory	L'annuaire du groupe d'étude du Livre d'Urantia
Holiday Party at Urantia Foundation	Fête de Noël à la Fondation Urantia
Adventures in Placing The Urantia Book	Aventures dans le placement du Livre d'Urantia
Growing Old Gracefully	Vieillir gracieusement
Job Opening At Urantia Foundation	Job Ouverture à la Fondation Urantia
A Reader's Comment	Commentaire d'un lecteur
Volume 8, 2014	Volume 8, 2014
Volume 8, Issue 1, March 2014	Volume 8, numéro 1, mars 2014
Welcome & Contact Details	Bienvenue et coordonnées
A Survey of Translators and Revisers of The Urantia Book	Une enquête auprès des traducteurs et des réviseurs du Livre d'Urantia
Noteworthy Decisions from the January 2014 Board of Trustees Meeting	Décisions remarquables de la réunion du Conseil d'administration de janvier 2014
The Urantia Book in the Philippines: an Outreach Project Update	Le Livre d'Urantia aux Philippines : une mise à jour du projet de sensibilisation
Restoring the Birthplace of the Fifth Epochal Revelation	Restaurer le lieu de naissance de la cinquième révélation d'époque
Churchification	Churchification
The Study Group Symposium	Le symposium du groupe d'étude
Preparing For My First International Conference	Préparer ma première conférence internationale
What the Women Are Planning: a Report from our Second Gathering	Ce que les femmes prévoient : un rapport de notre deuxième rassemblement
A Reader's Comment	Commentaire d'un lecteur
Volume 8, Issue 2, July 2014	Volume 8, numéro 2, juillet 2014
Welcome & Contact Details	Bienvenue et coordonnées
Behind the Scenes of the Hebrew Translation Project	Dans les coulisses du projet de traduction en hébreu
Noteworthy Decisions from the April 2014 Board of Trustees Meeting	Décisions remarquables de la réunion du Conseil d'administration d'avril 2014
The Urantia Book: A Blessing for Ukraine	Le Livre d'Urantia : une bénédiction pour l'Ukraine
The International Book Fair in Bogotá, Colombia	La Foire internationale du livre de Bogotá, Colombie
Second In-depth Revision of the French Translation	Deuxième révision en profondeur de la traduction française
The Urantia Book Study Group Directory	Le Groupe d'étude du Livre d'Urantia Directory
Journal of a Journey: Seeding Urantia Books in the Caribbean	Journal d'un voyage : Semer les livres d'Urantia dans les Caraïbes
The Urantia Book in the Philippines	Le Livre d'Urantia aux Philippines
A Workshop on the Soul	Un atelier sur le
Trip to the Holy Land	voyage de l'âme en Terre Sainte
Volume 8, Issue 3, Sept. 2014	Volume 8, numéro 3, septembre 2014
Welcome & Contact Details	Bienvenue et coordonnées Ce
Happenings in Indonesia	qui se passe en Indonésie
Noteworthy Decisions from the July 2014 Board of Trustees Meeting	Décisions remarquables du Conseil d'administration de juillet 2014 Réunion des administrateurs
The Urantia Book in Guatemala	Le Livre d'Urantia au Guatemala
Joint Seminar of the Education Committees of Three Major Urantia Organizations	Séminaire conjoint des comités d'éducation de trois organisations majeures d'Urantia
International Conference 2014: A Personal Experience	Conférence internationale 2014 : Une expérience personnelle
A Dream Come True: Experiencing Urantia Foundation and the Study Group Symposium	Un rêve devenu réalité : Faire l'expérience de la Fondation Urantia et du Symposium des groupes d'étude
The Study Group Symposium: Report on the Speeches	Le Symposium des groupes d'étude : Rapport sur les discours
The Beauty of Sharing: Seeding the teachings in Indonesia	La beauté de Partager : Semer les enseignements en Indonésie
Finding The Urantia Book in Nigeria: an Answer to my Childhood Prayer	Trouver le Livre d'Urantia au Nigeria : une réponse à mes prières d'enfance
Announcements	Annonces
Volume 8, Issue 4, Dec. 2014	Volume 8, Numéro 4, décembre 2014
Welcome & Contact Details	Bienvenue et coordonnées
Urantia Foundation's Year-End Fundraising Match	Match de collecte de fonds de fin d'année de la Fondation Urantia
Noteworthy Decisions from the October 2014 Board of Trustees Meeting	Décisions remarquables du Conseil d'administration d'octobre 2014 Rencontrer
Urantia, Nebadon, and the Master Universe: A New Film on Perspectipe	Urantia, Nébadon et le Maître Univers : un nouveau film sur Perspectipe
An Update from the Education Committee	Une mise à jour du comité d'éducation
A Beach Retreat: What Prayer Was to Jesus	Une retraite sur la plage : ce qu'était la prière pour Jésus
Reflections from The Women's Retreat	Réflexions de la Retraite des Femmes
Comments from the Soul Workshop	L'inscription commence bientôt pour le Livre d'Urantia École Internet trimestre d'avril
What The Urantia Book Means to Me	Commentaires de l'atelier Soul
Urantia Book Holiday Sale	Ce que le Livre d'Urantia signifie pour moi
Volume 9, 2015	Vente de vacances du Livre d'Urantia
Volume 9, Issue 1, March 2015	Volume 9, 2015
Welcome & Contact Details	Volume 9, Numéro 1, mars 2015
A Urantia Book Booth at the Parliament of the Worlds Religions	Bienvenue et coordonnées
Foundation Highlights of 2014	Un stand du Livre d'Urantia au Parlement de la
Noteworthy Decisions from the January 2015 Board of Trustees Meeting	Fondation des Religions du Monde Faits saillants de 2014
The 2015 Intemational Book Fair in Jerusalem	Décisions remarquables du Conseil d'administration de janvier 2015 Réunion des administrateurs
Disseminating The Urantia Book in Ukraine	La Foire internationale du livre 2015 à Jérusalem
What The Urantia Book Means to Me?	Diffusion du Livre d'Urantia en Ukraine
Urantia Book Outreach in the Philippines	Que signifie le Livre d'Urantia pour moi ?
How Discovering The Urantia Book Has Affected My Life	Sensibilisation au Livre d'Urantia aux Philippines
Announcements	Comment la découverte du Livre d'Urantia a affecté ma vie
Volume 9, Issue 2, June 2015	Annonces
Welcome & Contact Details	Volume 9, numéro 2, juin 2015
The Italian Translation of The Urantia Book	Bienvenue et coordonnées
Noteworthy Decisions from the April 2015 Board of Trustees Meeting	La traduction italienne du Livre d'Urantia
My Reflections after the Book Expo America	Décisions remarquables de la réunion du conseil d'administration d'avril 2015
The Bogotá International Book Fair	Mes réflexions après le livre Expo America
A Cooperative Venture at the Chicago Lit Fest	La Foire internationale du livre de Bogotá
The Foundation's Photo Gallery: Preserving History	Une entreprise coopérative au Chicago Lit Fest
What The Urantia Book Means to Me	La galerie de photos de la Fondation : Préserver l'histoire
My Quest to Find Answers	Ce que le Livre d'Urantia signifie pour moi
Annoucements	Ma quête pour trouver des réponses
Volume 9, Issue 3, Sept. 2015	Annonces
Welcome & Contact Details	Volume 9, numéro 3, septembre 2015
A Gathering of Readers in Italy	Bienvenue et coordonnées
Noteworthy Decisions from the July 2015 Board of Trustees Meeting	Un rassemblement des lecteurs en Italie
The Highest Joy	Décisions remarquables de la réunion du conseil d'administration de juillet 2015
Remembering Luiz Carlos Dolabela Chagas	La plus grande joie
The Worship Experience at SSS15	en souvenir de Luiz Carlos Dolabela Chagas
Looking Back at the UAI 2015 Québec Conference	L'expérience d'adoration à SSS15
October 12, 1955	Retour sur la conférence de l'AUI 2015 à Québec
Thoughts and Reflections on What The Urantia Book Means to me	12 octobre 1955
Volume 9, Issue 4, Dec. 2015	Pensées et réflexions sur ce que le Livre d'Urantia signifie pour moi
Welcome & Contact Details	Volume 9, numéro 4, décembre 2015
Urantia Foundation's Year-End Fundraising Match	Bienvenue et coordonnées
Noteworthy Decisions from the October 2015 Board of Trustees Meeting	Match de collecte de fonds de fin d'année de la Fondation Urantia
The Urantia Book at the Parliament of the World's Religions	Décisions remarquables de la réunion du Conseil d'administration d'octobre 2015
Money Matters Matter	Le Livre d'Urantia au Parlement des religions du monde
The Work of the Urantia Book Internet School (UBIS)	L'argent compte,
Living a Compassionate Life—A Urantia Foundation Workshop	le travail du Livre d'Urantia Internet École (UBIS)
Dancing with God: Weaving the Tapestry of the Supreme	Vivre une vie compatissante – Un atelier de la Fondation Urantia
A Urantia Book Youth Turns Forty	Danser avec Dieu : Tisser la tapisserie du Suprême
Volume 10, 2016	Un Livre d'Urantia La jeunesse fête ses quarante ans
Volume 10, Issue 1, March 2016	Volume 10, 2016
Welcome & Contact Details	Volume 10, Numéro 1, mars 2016
The Urantia Book in Cameroon: Reflections from a Study Group Leader	Bienvenue et coordonnées
Noteworthy Decisions from the January 2016 Board of Trustees Meeting	Le Livre d'Urantia au Cameroun : Réflexions d'un responsable d'un groupe d'étude
Science Symposium 2016	Décisions remarquables de la réunion du conseil d'administration de janvier 2016
UBIS: A student's Perspective	Symposium scientifique 2016
2016 Joint Conference—Time Dwindles and Planning Intensifies	UBIS : le point de vue d'un étudiant
The Women 's Assembly— an Uplifting Experience	Conférence conjointe 2016 — La diminution du temps et la planification s'intensifient
Registration Starts Soon for The Urantia Book Internet School April Trimester	L'Assemblée des femmes — une expérience édifiante
How The Urantia Book Inspires Giving	Comment le Livre d'Urantia inspire Donner
Volume 10, Issue 2, June 2016	du volume 10, numéro 2, juin 2016
Welcome & Contact Details	Bienvenue et coordonnées
Remaining Relevant: Urantia Fundation Announces Urantia Press	Rester pertinent : La Fondation Urantia annonce à Urantia Press
Noteworthy Decisions from the March 2016 Board of Trustees Meeting	les décisions remarquables de la réunion du Conseil d'administration de mars 2016
The Revision of the Portuguese Translation of The Urantia Book	La révision de la traduction portugaise du Livre d'Urantia
Reflections on the 2016 Science Symposium	Réflexions sur le Symposium scientifique 2016
The Summer Conference in San Antonio	La Conférence d'été à San Antonio
The 2016 Bogotá International Book Fair	L'International de Bogotá 2016 Salon du livre
CosmicCreations—An Outreach Effort	CosmicCreations – Un effort de sensibilisation
What Did, Does, and Will The Urantia Book Mean To?	Que signifie, signifie et signifiera le Livre d'Urantia ?
Volume 10, Issue 3, Sept. 2016	Volume 10, numéro 3, septembre 2016
Welcome & Contact Details	Bienvenue et coordonnées
A Report on Translations of The Urantia Book	Un rapport sur les traductions du Livre d'Urantia
Noteworthy Decisions from the July 2016 Board of Trustees Meeting	Décisions remarquables de la réunion du Conseil d'administration de juillet 2016
Volume 10, Issue 4, Dec. 2016	Volume 10, numéro 4, décembre 2016
Welcome & Contact Details	Bienvenue et coordonnées Décisions remarquables
Stewardship	de gestion des
Noteworthy Decisions from the October 2016 Board of Trustees Meeting	décisions d'octobre Réunion du Conseil d'administration 2016
A New Library of Human Source Books	Une nouvelle bibliothèque de livres de source humaine
The First Conference for Readers of The Urantia Book in Russia	La première conférence pour les lecteurs du Livre d'Urantia en Russie
2016 European Urantia Conference in Budapest—Who is Jesus?	La Conférence européenne d'Urantia 2016 à Budapest – Qui est Jésus ?
The Latin American Conference—The Teacher and the Student	La Conférence latino-américaine – L'enseignant et l'élève
Dancing with God: Embodying the Love of God	dansant avec Dieu : incarner l'amour de Dieu
Cathy Jones, “Our Cathy”	Cathy Jones, Cercles de confiance « Notre Cathy »
Circles of Trust: An Experience in Soul Sharing	: Une expérience de partage d'âmes
The World's Best Stories	Les meilleures histoires du monde
Volume 11, 2017	Volume 11, 2017
Volume 11, Issue 1, March 2017	Volume 11, numéro 1, mars
Welcome & Contact Details	Bienvenue et coordonnées 2017
Joint Education Seminar at Urantia Foundation Focuses on Sharing the Teachings	Le séminaire conjoint d'éducation à la Fondation Urantia se concentre sur le partage des enseignements
Noteworthy Decisions from the January 2017 Board of Trustees Meeting	Décisions remarquables de la réunion du conseil d'administration de janvier 2017
The Polish Translation After Six Years	La traduction polonaise après six ans
Report from the Finnish Office	Rapport du bureau finlandais
Mission Accomplished—A Urantia Conference in Ghana	Mission accomplie : une conférence Urantia au Ghana
My Experience As a Urantia Book Internet School Facilitator	Mon expérience en tant qu'Urantia Livre Internet Animateur scolaire
The Girl in the Pink Shirt	La Fille à la chemise rose
Dancing with God: Emerging in Sacredness—A Daughters of God Retreat	Danser avec Dieu : Émerger dans le sacré – Une retraite des Filles de Dieu
Circles of Trust: An Experience in Soul Sharing	Cercles de confiance : Une expérience de partage d'âmes
The Greatest Stories Ever Told	Les plus grandes histoires jamais racontées
Volume 11, Issue 2, June 2017	Volume 11, numéro 2, juin 2017
Welcome & Contact Details	Bienvenue et coordonnées
Seeding The Urantia Book in the Philippines: Tour Number Three	Seeding Le Livre d'Urantia aux Philippines : Tournée numéro trois
Noteworthy Decisions from the April 2017 Board of Trustees Meeting	Décisions remarquables de la réunion du Conseil d'administration d'avril 2017
Translations and Unity	Traductions et Unity
BookExpo America 2017	BookExpo America 2017
The UBIS Experience	L'expérience UBIS
The International Book Fair in Bogotá	La Foire internationale du livre de Bogotá
God in Man—The Spanish Readers Gather	Dieu dans l'homme – Les lecteurs espagnols rassemblent
What Can the Emerging Philosophy of Living Do?	ce que peut la philosophie de vie émergente Faire?
Spiritual Rebirth—How The Urantia Book Transformed Me	Renaissance spirituelle – Comment le Livre d'Urantia m'a transformé
Announcements	Annonces
Volume 11, Issue 3, Oct. 2017	Volume 11, Numéro 3, octobre 2017
Welcome & Contact Details	Bienvenue et coordonnées
Free Downloads of The Urantia Book at urantia.org	Téléchargements gratuits du Livre d'Urantia sur urantia.org
Noteworthy Decisions from the July 2017 Board of Trustees Meeting	Décisions remarquables de la réunion du Conseil d'administration de juillet 2017
Urantia Foundation's Index of The Urantia Book	Index de la Fondation Urantia du Livre d'Urantia
Dancing With God: Emerging In Sacredness- A Retreat For Women At Urantia Foundation	Danser avec Dieu : Émerger dans le sacré - Une retraite pour les femmes à la Fondation Urantia
The 2018 Urantia Association International Conference	La Conférence internationale de l'Association Urantia 2018
The IC'17 Children's Program: How I Got By With A Lot Of Help From My Friends!	Le programme pour enfants IC'17 : Comment je m'en suis sorti avec beaucoup d'aide de mes amis !
Signs and Wonders	Signes et merveilles
Ask and You Shall Receive	Demandez et vous recevrez
Volume 11, Issue 4, Dec. 2017	Volume 11, Numéro 4, décembre 2017
Welcome & Contact Details	Bienvenue et coordonnées
Curing Blindness in Ethiopia	Guérir la cécité en Éthiopie
Noteworthy Decisions from the October 2017 Board of Trustees Meeting	Décisions remarquables de la réunion du Conseil d'administration d'octobre 2017
The Spanish Revision Team Visits Urantia Foundation	L'équipe de révision espagnole visite la Fondation Urantia
2017 Year-end Match	Match de fin d'année 2017
Sending Donations to Urantia Foundation	Envoi de dons à Fondation Urantia
A Look into the Future	Un regard vers l'avenir
A Urantia Book Booth at the Miami Book Fair	Un stand du Livre d'Urantia à la Foire du Livre de Miami
Season's Greetings: Reflections on True Gifts from The Urantia Book	Salutations de fin d'année : Réflexions sur les véritables dons du Livre d'Urantia
Volume 12, 2018	Volume 12, 2018
Volume 12, Issue 1, March 2018	Volume 12, Numéro 1, mars 2018
Welcome & Contact Details	Bienvenue et coordonnées
The Revelation Bridge Endowment Fund-Securing the Future for The Urantia Book and Its Teachings	The Revelation Bridge Endowment Fund-Securing l'avenir du Livre d'Urantia et de ses enseignements
Noteworthy Decisions from the January 2018 Board of Trustees Meeting	Décisions remarquables de la réunion du Conseil d'administration de janvier 2018
Sending Le Livre d'Urantia to Cameroon	Envoi du Livre d'Urantia au Cameroun
Urantia Book Internet School-Fellowship Across the Globe	École-Famille Internet du Livre d'Urantia à travers le monde
The Urantia Book in Fiji	Le Livre d'Urantia aux Fidji L'
Urantia Association and Urantia Foundation Meet at 533 in Chicago	Association Urantia et la Fondation Urantia se réunissent à 533 heures Chicago
Remembering Larry Watkins—Treasured Server of the Urantia Revelation	Se souvient de Larry Watkins—Serveur précieux de la Révélation d'Urantia
Appreciating Sue Tennant	Appréciant Sue Tennant
The Pipeline Of Light—Seeding The Urantia Book Worldwide	Le pipeline de lumière—Semer le Livre d'Urantia dans le monde entier
A Way To Be of Service	Une façon d'être au service
What The Urantia Book Means to Me	Ce que le Livre d'Urantia signifie pour moi
The Urantia Book Fellowship's Summer Study Session 2018	Session d'étude d'été 2018 de la Communauté du Livre d'Urantia
“Dancing with God—Courageously Living His Love”	« Danser avec Dieu — Vivre courageusement son amour »
Volume 12, Issue 2, July 2018	Volume 12, numéro 2, juillet 2018
Welcome & Contact Details	Bienvenue et coordonnées
Richard Keeler Retires	Richard Keeler prend sa retraite
Noteworthy Decisions from the April 2018 Board of Trustees Meeting	Décisions remarquables de la réunion du conseil d'administration d'avril 2018
The Parables Book—A Resource for Outreach	Le Livre des Paraboles—Une ressource pour la sensibilisation
A Knowledgeable Guide to Point the Way—Urantia Foundation's Index	Un guide compétent pour montrer la voie—Index de la Fondation Urantia
Jesus as a Teacher—2018 International Conference in Amsterdam	Jésus en tant qu'enseignant—Conférence internationale 2018 à Amsterdam
Ghana—The Teachings Spread with Conferences and Gift Books	Ghana—Les enseignements diffusés avec des conférences et des livres-cadeaux
Celebrating Marjorie Reed	célébrant Marjorie Reed
Spreading The Urantia Book Throughout Italy	diffusant le Livre d'Urantia dans toute l'Italie
Announcements	Annonces
Volume 12, Issue 3, Oct. 2018	Volume 12, numéro 3, octobre 2018
Welcome & Contact Details	Bienvenue et coordonnées
A Way to Serve and to Seed-Urantia Foundation Sends 600 Books to Latin America	Une manière de servir et de semer- La Fondation Urantia envoie 600 livres en Amérique latine
Noteworthy Decisions from 2 the July 2018 Board of Trustees Meeting	Décisions remarquables du 2 juillet 2018 Mise à jour de la réunion du Conseil d'administration
Update: Outreach in the Philippines	: Sensibilisation aux Philippines
The Challenges of Translating The Urantia Book	Les défis de la traduction du Livre d'Urantia
The Urantia Book Study Group Directory Launched a New Website	L'annuaire du groupe d'étude du Livre d'Urantia a lancé un nouveau site Web
Reflections of the 2018 Summer Study Session	Réflexions de la session d'étude d'été 2018
Urantia Foundation to Attend the 2018 Parliament of the World's Religions	La Fondation Urantia participera au Parlement des Religions du Monde 2018
What The Urantia Book Means to Me	Décisions remarquables du 2 janvier 2020
Announcements	Ce que le Livre d'Urantia signifie pour moi
Volume 12, Issue 4, Dec. 2018	Annonces
Welcome & Contact Details	Volume 12, Numéro 4, décembre 2018
It's the Season of Giving	Bienvenue et coordonnées
Noteworthy Decisions from the October 2018 Board of Trustees Meeting	C'est la saison des
UBIS Gets a Makeover	décisions remarquables de la réunion du conseil d'administration d'octobre 2018
Our Experiences at the 2018 Parliament of the World 's Religions	L'UBIS fait peau neuve
Dancing with God: The Fifth Annual Women's Retreat	Nos expériences au Parlement des religions du monde 2018
Seeding The Urantia Book in Romania	Danse avec Dieu : Le Cinquième retraite annuelle des femmes
What The Urantia Book Means to Me	Semer le Livre d'Urantia en Roumanie
Announcements	Ce que le Livre d'Urantia signifie pour moi
Volume 13, 2019	Annonces
Volume 13, Issue 1, April 2019	Volume 13, 2019
Welcome & Contact Details	Volume 13, Numéro 1, avril 2019
Our Brother Richard	Bienvenue et coordonnées
Noteworthy Decisions from the January 2019 Board of Trustees Meeting	Notre frère Richard
The Untold Story of Jesus: A Modern Biography from The Urantia Book	Décisions remarquables de la réunion du Conseil d'administration de janvier 2019
Global Cultural Symposium at Urantia Foundation	L'histoire inédite de Jésus : Une biographie moderne tirée du Livre d'Urantia
The UBIS Experience—Behind the Scenes	Symposium culturel mondial à la Fondation Urantia
What The Urantia Book Means to Me 	L'expérience UBIS — Dans les coulisses
Announcements	Ce que le Livre d'Urantia signifie pour moi
Volume 13, Issue 2, July 2019	Annonces
Welcome & Contact Details	Volume 13, numéro 2, juillet 2019
Creating Translations out of Love: Urantia Foundation's Quality Process	Bienvenue et coordonnées
Noteworthy Board Decisions from the April 2019 Trustees Meeting	Créer des traductions par amour : Urantia Processus de qualité de la Fondation
Urantia Foundation's Global Cultural Symposium	Décisions remarquables du conseil d'administration de la réunion des administrateurs d'avril 2019
My Personal Experience At The Cultural Symposium	Symposium culturel mondial de la Fondation Urantia
Ways to Help Spread the Urantia Revelation	Mon expérience personnelle au symposium culturel
CosmicCreations—Our Service Project	Comment aider à diffuser la révélation d'Urantia
Celebrating Moussa N'Diaye and Norman Ingram	CosmicCreations—Notre projet de service
What The Urantia Book Means to Me	Célébrer Moussa N'Diaye et Norman Ingram
Announcements	Ce que signifie le Livre d'Urantia pour
Volume 13, Issue 3, Oct. 2019	Annonces Me
Welcome & Contact Details	Volume 13, Numéro 3, octobre 2019
The Spanish Revision Is Almost Finished	Bienvenue et coordonnées
Noteworthy Board Decisions from the July 2019 Trustees Meeting	La révision espagnole est presque terminée
Study Groups and Translations	Décisions remarquables du Conseil d'administration de la réunion du conseil d'administration de juillet 2019
The Second UAI European Conference in Tallinn	Groupes d'étude et traductions
Remembering Mark Bloomfield	La deuxième conférence européenne de l'AUI à Tallinn
Announcements	en souvenir de Mark Bloomfield
Volume 13, Issue 4, Dec. 2019	Annonces
Welcome & Contact Details	Volume 13, Numéro 4 , décembre 2019
Together We Can Make a Diference	Bienvenue et coordonnées
Noteworthy Decisions from the October 2019 Trustees Meeting	Ensemble, nous pouvons faire une différence
My Impressions of the Spanish Revision	Décisions remarquables de la réunion des administrateurs d'octobre 2019
Science Symposium 2019	Mes impressions du
A Celebration of Souls	Symposium scientifique de révision en espagnol 2019
The Presence of Urantia Peru at the Cusco International Book Fair 2019	Une célébration des âmes
The Word, the Language, the Dictionary	La présence d'Urantia Pérou à la Foire internationale du livre de Cusco 2019
Dancing with God—Our Supreme Calling Retreat	La Parole, la langue, le dictionnaire
Seattle Hempfest Report	Danser avec Dieu – Notre retraite d'appel suprême
An Essay on Finding Truth	Rapport du Seattle Hempfest
Announcements	Un essai pour trouver la vérité
Volume 14, 2020	Annonces
Volume 14, Issue 1, April 2020	Volume 14, 2020
Welcome & Contact Details	Volume 14, numéro 1, avril 2020
A Filipino Translation of The Urantia Book	Bienvenue et coordonnées
Noteworthy Decisions from 2 the January 2020 Trustees Meeting	Une traduction philippine du Livre d'Urantia
Remembering Carmelo María Martínez Ortiz De Zarate 1947-2020	En souvenir de Carmelo María Martínez Ortiz De Zarate 1947-2020
Online Education—A Global Mission	L’éducation en ligne – Une mission mondiale
The 2019 Urantia Book Conference in the Philippines	La Conférence du Livre d’Urantia 2019 aux Philippines
A Story of Three Audiobooks	Une histoire de trois livres audio
Sharing The Urantia Book	partageant le Livre d'Urantia
Announcements	Annonces
Volume 14, Issue 2, June 2020	Volume 14, Numéro 2, juin 2020
Welcome & Contact Details	Bienvenue et coordonnées
The Indonesian Translation: A Journey with The Urantia Book	La traduction indonésienne : Un voyage avec le Livre d'Urantia
Updates from the April 2020 Board Meeting	Mises à jour de la réunion du Conseil d'administration d'avril 2020
Steve Dreier: A Tribute	Steve Dreier : Un hommage
Urantia Association's Second 24-Hour Online Event	Les deuxièmes 24 heures de l'Association Urantia Événement en ligne
What The Urantia Book Means to Me	Ce que le Livre d'Urantia signifie pour moi
Announcements	Annonces
Volume 14, Issue 3, Oct. 2020	Volume 14, numéro 3, octobre 2020
Welcome & Contact Details	Bienvenue et coordonnées
The First Chinese Conference: An Unprecedented International Endeavor	La première conférence chinoise : un effort international sans précédent
Updates from the July 2020 Trustee Meeting	Mises à jour de la réunion des administrateurs de juillet 2020
The Satisfactions of (Reader) Service	Les satisfactions du service (des lecteurs) L'
The Urantia Book Historical Society has a New Archive	historique du Livre d'Urantia La société a de nouvelles archives
What The Urantia Book Means to Me	Ce que le Livre d'Urantia signifie pour moi
Planned Giving	Annonces
Announcements	de dons planifiés
Volume 14, Issue 4, Dec. 2020	Volume 14, numéro 4, décembre 2020
Welcome & Contact Details	Bienvenue et coordonnées
Infinite Treasures Are Ours	Les trésors infinis sont à nous
The Standard Reference Text—Historical Context and Purpose	Le texte de référence standard — Contexte historique et objectif
Updates from the October 2020 Trustee Meeting	Mises à jour de la réunion des administrateurs d'octobre 2020
Chinese Conference Generates Enthusiasm for The Urantia Book	Conférence chinoise Génère de l'enthousiasme pour le Livre d'Urantia
Remembering Carolyn Kendall	En souvenir de Carolyn Kendall
Urantia Book Internet School—an Opportunity for Spiritual Growth and Brotherhood	L'École Internet du Livre d'Urantia – une opportunité de croissance spirituelle et de fraternité
Urantia Book Internet School—a Brazilian Experience	L'École Internet du Livre d'Urantia – une expérience brésilienne
What The Urantia Book Means to Me-the Dimensions of God	Ce que le Livre d'Urantia signifie pour moi – les dimensions de Dieu
Announcements	Annonces
Volume 15, 2021	Volume 15, 2021
Volume 15, Issue 1, April 2021	Volume 15, Numéro 1er avril 2021
Welcome & Contact Details	Bienvenue et coordonnées
Springtime for the New El libro de Urantia	Printemps pour le nouveau El libro de Urantia
Updates from the January 2021 Trustee Meeting	Mises à jour de la réunion des administrateurs de janvier 2021
The Urantia Book in Europe—Our Journey Building a Distribution Network	Le Livre d'Urantia en Europe – Notre voyage Construire un réseau de distribution
Loving Service Spiritual Retreat —The Power of Stories	Service avec amour Retraite spirituelle – Le pouvoir des histoires
Urantia Foundation Outreach Committee	Comité de sensibilisation de la Fondation Urantia
Dancing with God—Living in Love in Trying Times	Danser avec Dieu — Vivre dans l'amour dans des temps difficiles
New Enhanced English E-book	Nouveau livre électronique en anglais amélioré
Learn About the New Revision of El Libro de Urantia	Découvrez la nouvelle révision du Livre d'Urantia
Volume 15, Issue 2, July 2021	Volume 15, Numéro 2, juillet 2021
Welcome & Contact Details	Bienvenue et coordonnées
Taking It to a New Level: The Urantia Book in Esperanto	Passer à un nouveau niveau : Le Livre d'Urantia en espéranto
Updates from the April 2021 Trustee Meeting	Mises à jour de la réunion des administrateurs d'avril 2021
My Experiences with the Spanish Revision	Mes expériences avec la révision espagnole
Distributing Het Urantia Boek in the Netherlands and Belgium	Distribuer Het Urantia Boek aux Pays-Bas et en Belgique
Experiencing International Brotherhood through Urantia Book Internet School	Vivre la fraternité internationale à travers le Livre d'Urantia Internet
Teamwork: A Virtual Conference Experience	Travail d'équipe scolaire : Une expérience de conférence virtuelle
What The Urantia Book Means to Me	Ce que le Livre d'Urantia signifie pour moi
Announcements	Annonces
Volume 15, Issue 3, Sept. 2021	Volume 15, numéro 3, septembre 2021.
Welcome & Contact Details	Bienvenue et coordonnées 2021
Maximizing Outreach with an Android App	Maximiser la sensibilisation avec une application Android
Updates from the July Trustee Meeting	Une décennie de qualité et de dévouement — la révision du Libro de Urantia
A Decade of Quality and Dedication — the Revision of El Libro de Urantia	Mises à jour de la réunion des administrateurs de juillet
The Effect of Supply Chains on Book Printing and Distribution	L'effet des chaînes d'approvisionnement sur l'impression et la distribution des livres
The Enduring Legacy of Two Great Teachers	L'héritage durable de deux grands enseignants
A Quadrimillennial Appreciation of Machiventa Melchizedek	Une appréciation quadrimillénaire de Machiventa Melchizédek
Three Concentric Circles — Our Michael Son's Banner	Trois cercles concentriques — la bannière de notre fils Michael
Sharing The Urantia Book	Partager le Livre d'Urantia
What The Urantia Book Means to Me	Ce que le Livre d'Urantia signifie pour moi
Science Symposium III	Symposium scientifique III
Volume 16, 2022	Volume 16, 2022
Volume 16, Issue 1, Jan. 2022	Volume 16, numéro 1, janvier 2022
Welcome & Contact Details	Bienvenue et coordonnées
2022 Here We Come!	2022 Nous voilà !
Updates from the October 2021 Trustee Meeting	Mises à jour de la réunion des administrateurs d'octobre 2021
The Chinese Translation: An Update	La traduction chinoise : une mise à jour
Circling the Globe with UBIS	faisant le tour du globe avec UBIS
My Benelux Esperanto Conference Experience	Mon expérience de conférence Benelux
Remembering Irmeli Ivalo-Sjõlie	en espéranto En souvenir d'Irmeli Ivalo-Sjõlie
Sharing The Urantia Book	partageant le Livre d'Urantia
What The Urantia Book Means to Me	Ce que le Livre d'Urantia signifie pour moi
Volume 16, Issue 2, March 2022	Volume 16, numéro 2, mars 2022
Welcome & Contact Details	Bienvenue et contact Détails
Ksiega Urantii: How the Polish Translation Came to Be	Ksiega Urantii : Comment la traduction polonaise est née Mises à
Updates from the January 2022 Trustee Meeting	jour de la réunion des administrateurs de janvier 2022
The Inquiring Greeks: A Chronicle of the Greek Translation of The Urantia Book	Les Grecs curieux : Une chronique de la traduction grecque du Livre d'Urantia
Urantia Foundation: Enhancing a Global Movement	Fondation Urantia : Renforcer un mouvement mondial
An Indispensable Partnership: The Pipeline of Light	Un partenariat indispensable : Le pipeline de lumière
Collaboration and Spiritual Unity: The Urantia Book Study Group Directory	Collaboration et spiritualité Unité : Répertoire du groupe d'étude du Livre d'Urantia
Joining the Team at Urantia Foundation	Rejoindre l'équipe de la Fondation Urantia
Sharing The Urantia Book	Partager le Livre d'Urantia
What The Urantia Book Means to Me	Ce que le Livre d'Urantia signifie pour moi
Announcements	Annonces
Volume 16, Issue 3, July 2022	Volume 16, numéro 3, juillet 2022
Welcome & Contact Details	Bienvenue et coordonnées
Science: The Interface of Evolution and Revelation	Science : L'interface de l'évolution et de la révélation
Updates from the April 2022 Trustee Meeting	Mises à jour d'avril Réunion des administrateurs 2022
The Cultural Advisory Council Welcomes Brazil	Le Conseil consultatif culturel accueille l'
Urantia Book Internet School—Study Groups for New Readers	École Internet du Livre d'Urantia au Brésil – Des groupes d'étude pour les nouveaux lecteurs
Three Ways to Help Spread the Urantia Revelation	Trois façons d'aider à diffuser la révélation d'Urantia
A Tribute to Dr. Marta Elders—Our Love of a Lady	Un hommage au Dr. Marta Aînés – Notre amour d'une dame
What The Urantia Book Means to Me	Ce que le Livre d'Urantia signifie pour moi
Announcements	Annonces
Volume 16, Issue 4, Oct. 2022	Volume 16 , numéro 4, octobre 2022
Welcome & Contact Details	Bienvenue et coordonnées
Urantia Books across the Globe	Les Livres d'Urantia à travers le monde
Updates from the July 2022 Trustee Meeting	Mises à jour de la réunion des administrateurs de juillet 2022
Quality TranslationsA 40—Year Process!	Des traductions de qualitéUn processus de 40 ans !
The Revelation Flourishes in the Philippines	La Révélation s'épanouit aux Philippines
Serving as Trustees of Urantia Foundation	Servir en tant qu'administrateurs de la Fondation Urantia
The Cultural Advisory Council Welcomes Colombia	Le Conseil Consultatif Culturel accueille la Colombie
Growing a School out of Love for the Revelation	Créer une école par amour pour la Révélation
Sharing The Urantia Book	Partager le Livre d'Urantia
What The Urantia Book Means to Me	Ce que le Livre d'Urantia signifie pour moi
Announcements	Annonces
Volume 16, Issue 5, Dec. 2022	Volume 16, Numéro 5, décembre 2022
Welcome & Contact Details	Bienvenue et Coordonnées
The Assurance of God's Unbreakable Promises	L'assurance des promesses incassables de Dieu
Updates from the October 2022 Trustee Meeting	Mises à jour de la réunion des administrateurs d'octobre 2022
The Cultural Advisory Council Welcomes Poland	Notre stand du livre d'Urantia au Salon du livre de Cali, Colombie
Nurturing the Revelation in the Philippines	Le Conseil consultatif culturel accueille la Pologne
Our Urantia Book Stand at the Cali, Colombia Bookfair	Nourrir la révélation aux Philippines
Third European Conference of Urantia Book Readers—Overcoming Materialism and Enlightening Europe	Troisième Conférence européenne des lecteurs du Livre d'Urantia — Vaincre le matérialisme et éclairer l'Europe
Sharing The Urantia Book	Partager le Livre d'Urantia
What The Urantia Book Means to Me	Ce que le Livre d'Urantia signifie pour moi
Announcements	Annonces
Volume 17, 2023	Volume 17, 2023
Volume 17, Issue 1, March 2023	Volume 17, Numéro 1, mars 2023
Welcome & Contact Details	Bienvenue et coordonnées Les mises à jour
The Mustard Seed Grants Program	du programme de subventions aux graines de moutarde
Updates from the January 2023 Trustee Meeting	de janvier Réunion des administrateurs 2023
An Epochal Plan	Un plan d'époque
Urantia Book International School Virtual Study Groups	Les groupes d'étude virtuels de l'École internationale du Livre d'Urantia
Remembering Tonia Baney	se souviennent de Tonia Baney
What The Urantia Book Means to Me	Ce que le Livre d'Urantia signifie pour moi
Announcements	Annonces