Index of The Study Group Herald articles	Index des articles du Study Group Herald
Volume 1 — 1991	Volume 1 — 1991
December 1991 — Vol. 1 No. 2	Décembre 1991 — Vol. 1 n°2
Issue Content, December 1991	The Study Group Herald — Contenu du numéro, décembre 1991
The Study Groups Around Oklahoma City	Les groupes d’étude autour d’Oklahoma City
Studies In Marriage, Home And Children	Études sur le mariage, le foyer et les enfants
A Vision of Angels	Une vision des anges
Mother Of My Soul...	Mère de mon âme...
A History of the Urantia Papers	Une histoire des Cahiers d’Urantia
Lighten Life News	Allégez la vie Nouvelles
Facts from Urantia Files	Faits tirés des Fichiers Urantia
The Water of Astonishment	L’eau de l’étonnement
What Am I? Who Am I? An Introspection Of Myself	Que suis je? Qui suis je? Une introspection de moi-même
Message to my soul	Message à mon âme
Periodicals of the Movement	Périodiques du Mouvement
On Deity and Gender	Sur la divinité et le genre
A Life for All Seasons	Une vie pour toutes les saisons
Letters	Des lettres
Classifieds	Petites annonces
Bulletin Board	Tableau d’affichage
A Prayer for Community and Love	Une prière pour la communauté et l’amour
God's Love and His Law	L’amour de Dieu et sa loi
Volume 2 — 1992	Volume 2 — 1992
December 1992 — Vol. 2 No. 3	Décembre 1992 — Vol. 2 n ° 3
Issue Content, December 1992	The Study Group Herald — Contenu du numéro, décembre 1992
Children In The Urantia Movement	Les enfants dans le mouvement Urantia
Excerpts from the letters	Extraits des lettres
20 20 20	20 20 20
Family Rituals And Celebrations	Rituels et célébrations familiales
Urantia Nuptials	Noces Urantia
Fatherhood: Jesus As A Creative Parental Role Model	Paternité : Jésus comme modèle parental créatif
Studies For Troubled Times	Études pour les temps troublés
Ascending Currents	Courants ascendants
An Interview with Clyde Bedell. Reminiscences Of An Early Forum Member	Une entrevue avec Clyde Bedell. Réminiscences d’un des premiers membres du forum
Facts from Urantia Files	Faits tirés des Fichiers Urantia
The Irish Study Group	Le groupe d’étude irlandais
Letters	Des lettres
Universal Love Father — A Poem, A Song	Père d’amour universel - Un poème, une chanson
The Soul As The Entrance Into True Community	L’âme comme entrée dans la vraie communauté
Letters	Des lettres
Classifieds	Petites annonces
Bulletin Board	Tableau d’affichage
1992 Calendar Of Events	Calendrier des événements 1992
Achieving Balance	Atteindre l’équilibre
Touch the World	Touchez le monde
From The Editor	De l’éditeur
Volume 3 — 1993	Volume 3 — 1993
August 1993 — Vol. 3 No. 4	Août 1993 — Vol. 3 n°4
Issue Content, August 1993	The Study Group Herald — Contenu du numéro, août 1993
To Share with Other Readers	À partager avec d’autres lecteurs
A Letter from New York State	Une lettre de l’État de New York
Childhood Days at the Forum	Journées de l’enfance au Forum
Ask and You Shal Receive	Demandez et vous recevrez
Caring for an Aging Parent	Prendre soin d’un parent vieillissant
A Memorial of a very Special Nature	Un mémorial d’une nature très particulière
An Experience with My Dad in a Nursing Home 	Une expérience avec mon père dans une maison de retraite
Letters	Des lettres
Motaquest	Motaquest
The Life and Times of Jesus	La vie et l’époque de Jésus
Jesus and Jude in Jerusalem Jail	Jésus et Jude dans la prison de Jérusalem
Ascending Currents	Courants ascendants
Florida Students of The Urantia Book	Étudiants de Floride du Livre d’Urantia
Letters	Des lettres
Classifieds	Petites annonces
Bulletin Board	Tableau d’affichage
Calendar	Calendrier
From The Editor	De l’éditeur
Volume 4 — 1994	Volume 4 — 1994
Fall 1994 — Vol. 4 No. 5	Automne 1994 — Vol. 4 n ° 5
Issue Content, Fall 1994	The Study Group Herald — Contenu du numéro, automne 1994
Initial Thoughts	Pensées initiales
In Memoriam	En mémoire
Who and How?	Qui et comment ?
Letters To The Herald	Lettres au héraut
Bulletin Board	Tableau d’affichage
International Letters	Lettres internationales
The Melchizedek Bestowal 	L’effusion de Melchisédek
Regarding Instructions or Mandates 	Concernant les instructions ou les mandats
For Teens, It's A Different World	Pour les adolescents, c'est un monde différent
Who Says Day Care Can't Be Fun?	Qui a dit que la garderie ne pouvait pas être amusante ?
The Burden of the Basket	Le fardeau du panier
Divorce: To Do or Not To Do?	Divorce : à faire ou à ne pas faire ?
Men and Women in Partnership	Hommes et femmes en partenariat
Abortion and The Urantia Book	L’avortement et le Livre d’Urantia
Family Life Values Survey	Enquête sur les valeurs de la vie familiale
Planetary Government of Urantia Additional Definitions and References	Gouvernement Planétaire d’Urantia Définitions et références supplémentaires
Study Groups of Arizona	Groupes d’étude de l’Arizona
The Urantia Book at the Parliament of World's Religions	Le Livre d’Urantia au Parlement des Religions du Monde
Enjoying the Spectacle of the Parliament	Profiter du spectacle du Parlement
The Grapevine	La vigne
Classifieds	Petites annonces
Ascending Currents	Courants ascendants
Volume 6 — 1996	Volume 6 — 1996
Spring/Summer 1996 — Vol. 6 No. 7	Printemps/Été 1996 — Vol. 6 n°7
Issue Content, Spring/Summer 1996	The Study Group Herald — Contenu du numéro, été 1996
Letters To The Fellowship	Lettres à la Fraternité
General Council Meets in San Francisco	Le Conseil général se réunit à San Francisco
Get Ready for IC '96	Préparez-vous pour IC '96
Dateline	Ligne de données
Little UrantiaL	Petite UrantiaL
Dare to Risk	Osez prendre des risques
The Science of Fatherhood	La science de la paternité
IC'96	IC'96
Graduation of Ruth E. Renn	Remise des diplômes de Ruth E. Renn
Calendar	Calendrier
Winter 1996 — Vol. 6 No. 8	Hiver 1996 — Vol. 6 n ° 8
Issue Content, Winter 1996	The Study Group Herald — Contenu du numéro, hiver 1996
Welcome to the New Study Group Herald	Bienvenue dans le nouveau Herald du groupe d’étude
Letters to the Fellowship	Lettres à la Fraternité
International Letters	Lettres internationales
A Place Apart	Un endroit à part
Defining Spiritual Service 	Définir le service spirituel
Reaching Out in Faith	Tendre la main avec foi
Last of Founding Trustees Passes Away	Décès du dernier des administrateurs fondateurs
Gearing Up for IC 96	Se préparer pour l’IC 96
Jesus — The Man, The Hero	Jésus - L’homme, le héros
A Hero For All	Un héros pour tous
Two Prayer Poems	Deux poèmes de prière
Dateline	Ligne de données
2,000th Birthday Party	Fête du 2 000e anniversaire
In Close Proximity — The World of the Nonbreathers	À proximité – Le monde des non-respirants
What Does Urantia Mean?	Que signifie Urantia ?
Study Groups of Tennessee	Groupes d’étude du Tennessee
Divine Nature	Nature divine
Calendar	Calendrier
Volume 7 — 1997	Volume 7 — 1997
Winter 1997 — Vol. 6 No. 9	Hiver 1997 — Vol. 6 n°9
Issue Content, Winter 1997	The Study Group Herald — Contenu du numéro, hiver 1997
Letters	Des lettres
IC 96 Coverage	Couverture IC 96
The Cosmic Family	La famille cosmique
Study Group Directory	Répertoire des groupes d’étude
Faith Makes All Things Possible & Love Makes Them Beautiful	La foi rend toutes choses possibles et l’amour les rend belles
We're All Connected	Nous sommes tous connectés
The Urantia Book in Lithuania	Le Livre d’Urantia en Lituanie
IC 96 Photo Essay	Essai photo IC 96
1997 Summer Seminar To Meet in Vancouver July 10-13	Le séminaire d’été 1997 aura lieu à Vancouver du 10 au 13 juillet
Three Rs: Relationship, Religion and Revelation	Trois R : relation, religion et révélation
Dateline	Ligne de données
News from Colombia	Nouvelles de Colombie
President's Report to the General Council	Rapport du président au Conseil général
The Fellowship Is Now On The WWW	La Fellowship est maintenant sur le WWW
Calendar Of Events	Calendrier des événements