Index des aides à l'étude	---------------------------------------	is-title	index, study aid
Les Cahiers d'exercices du Livre d'Urantia et autres ouvrages de William S. Sadler, MD		is-issue	-----
Avant-propos et Partie I — Volume I	/fr/article/William_S_Sadler/Workbook_1_Foreword_and_Part_I		Astronomy, Study Aid, William Sadler
Sciences — Volume II	/fr/article/William_S_Sadler/Workbook_2_Science		Astronomy, Study Aid, William Sadler
Études thématiques et doctrinales — Volume III	/fr/article/William_S_Sadler/Workbook_3_Topical_and_Doctrinal_Studies		Topical, Religion, Study Aid, William Sadler
Jésus — Volume IV	/fr/article/William_S_Sadler/Workbook_4_Jesus		Jesus, Study Aid, William Sadler
Théologie — Volume V	/fr/article/William_S_Sadler/Workbook_5_Theology		Theology, Study Aid, William Sadler
L'étude de la Bible — Volume VI	/fr/article/William_S_Sadler/Workbook_6_Bible_Study		Bible, Study Aid, William Sadler
Terminologie — Volume VII	/fr/article/William_S_Sadler/Workbook_7_Terminology		The Urantia Book, William Sadler
Adoration et Sagesse — Volume VIII	/fr/article/William_S_Sadler/Workbook_8_Worship_and_Wisdom		Worship, Study Aid, William Sadler
Examen de quelques critiques du Livre d'Urantia	/fr/article/William_S_Sadler/Consideration_some_criticisms_Urantia_Book		The Urantia Book, William Sadler
L'Histoire du Mouvement Urantia	/fr/article/William_S_Sadler/A_History_of_the_Urantia_Movement		The Urantia Book, The Urantia Book—Authorship, History of Urantia Movement, William Sadler
Œuvres de William S. Sadler, Jr.		is-issue	----
Une Étude du Maître Univers	/fr/article/William_S_Sadler_Jr/Study_of_the_Master_Universe		Astronomy, Cosmology, Study Aid, Bill Sadler
Appendices à Une Étude du Maître Univers	/fr/article/William_S_Sadler_Jr/Appendices_to_Study_of_the_Master_Universe		Astronomy, Cosmology, Study Aid, Bill Sadler
Les discussions de Bill Sadler	/fr/article/William_S_Sadler_Jr/Bill_Sadler_Talks		Study Aid, Bill Sadler
Concernant la survie humaine	/fr/article/William_S_Sadler_Jr/Concerning_Human_Survival		Study Aid, Bill Sadler
Organisation générale du Livre d'Urantia	/fr/article/William_S_Sadler_Jr/General_Organization_of_The_Urantia_Book		The Urantia Book, The Urantia Book—Papers, Study Aid, Bill Sadler
Autre		is-issue	----------
FAQ — Questions fréquemment posées à propos du Livre d’Urantia	/fr/article/FAQ		The Urantia Book, Questions and answers, Study Aid
Guide de prononciation des noms et des mots dans le Livre d'Urantia	/fr/article/Guide_of_Pronunciation		The Urantia Book, Study Aid
Comment les Urantia Papers ont vu le jour - selon The Revelators	/fr/article/Ralph_Zehr/How_The_Urantia_Papers_came_to_be	Compiled by Ralph Zehr	The Urantia Book—History, Study Aid
Une conception d'artiste du maitre univers	/fr/article/Artist_Conception_of_the_Master_Universe		Cosmology, Study Aid
Étude approfondie du Livre D’Urantia en groupe d’étude	/fr/article/Georges_Michelson_Dupont/Strategy_Practice_for_In_depth_Study_Groups	Georges Michelson-Dupont	tudy Groups, Study Aid
La Valeur des Groupes d’Étude	/fr/article/Gard_Jameson/The_Value_of_Study_Groups	Gard Jameson	Study Groups, Study Aid
La campagne incessante du maître séraphin	/fr/article/Neal_Waldrop/Unceasing_campaign_of_master_seraphim	Neal Waldrop	History of Urantia, Epochal Revelations, Angels and midwayers, Study Aid
Comment organiser un groupe d’étude virtuel avec Skype	/fr/article/Michael_Hanian/How_to_Host_a_Virtual_Study_Group_Using_Skype	Michael Hanian	Study Groups, Study Aid