Luz y Vida — No. 1 — May 2005	Luz y Vida — Núm. 1 — Mayo 2005
Luz y Vida — No. 1 — Presentation	Luz y Vida — Núm. 1 — Presentación
The seven superuniverses	Los siete superuniversos
The Trinitized Sons of God	Los Hijos de Dios trinidizados
The mansion worlds	Los mundos de estancia
The spheres of light and life	Las esferas de luz y vida
The evolution of prayer	La evolución de la oración
The Supreme Being	El Ser Supremo
After Pentecost	Después de Pentecostés
Faith of jesus	La fe de Jesús
Luz y Vida — No. 2 — September 2005	Luz y Vida — Núm. 2 — Septiembre 2005
Luz y Vida — No. 2 — Presentation	Luz y Vida — Núm. 2 — Presentación
A personal overview, part one	Un panorama personal, primera parte
The center of attention	El centro de atención
The Urantia Book_ in Africa: account of a trip to Dakar	El Libro de Urantia_ en África: relato de un viaje a Dakar
Meeting of May 14, 1999 in Dakar (Senegal), first part	Encuentro del 14 de mayo de 1999 en Dakar (Senegal), primera parte
Luz y Vida — No. 3 — December 2005	Luz y Vida — Núm. 3 — Diciembre 2005
Luz y Vida — No. 3 — Presentation	Luz y Vida — Núm. 3 — Presentación
A personal overview, part two	Un panorama personal, segunda parte
The substitutes	Los sustitutos
Meeting of May 14, 1999 in Dakar (Senegal), second part	Encuentro del 14 de mayo de 1999 en Dakar (Senegal), segunda parte
We are children of the Supreme	Somos hijos del Supremo
Luz y Vida — No. 4 — February 2006	Luz y Vida — Núm. 4 — Febrero 2006
Luz y Vida — No. 4 — Presentation	Luz y Vida — Núm. 4 — Presentación
A Personal View, Part Three	Un panorama personal, tercera parte
Friends and Residents on Urantia	Amigos y residentes en Urantia
What are the seven mansion worlds for?	¿Para qué sirven los siete mundos de las mansiones?
The data	El dato
An infinite moment (poem)	Un instante infinito (poema)
Discernment and free will	Discernimiento y libre albedrío
VI Meeting of Urantia Book Readers in Spain	VI Encuentro de Lectores del Libro de Urantia en España
Luz y Vida — No. 5 — May 2006	Luz y Vida — Núm. 5 — Mayo 2006
Luz y Vida — No. 5 — Presentation	Luz y Vida — Núm. 5 — Presentación
How to publicize The Urantia Book	Cómo dar a conocer El Libro de Urantia
Study groups	Los grupos de estudio
How to live the teachings of The Urantia Book	Cómo vivir las enseñanzas del Libro de Urantia
Chronicle of the VI Meeting	Crónica del VI Encuentro
Luz y Vida — No. 6 — September 2006	Luz y Vida — Núm. 6 — Septiembre 2006
Luz y Vida — No. 6 — Presentation	Luz y Vida — Núm. 6 — Presentación
Back with the Dissemination	A Vueltas con la Diseminación
Orvonton and the Milky Way	Orvonton y La Vía Láctea
God The Absolute	Dios El Absoluto
Beyond Mathematics	Más Allá de las Matemáticas
Luz y Vida — No. 7 — December 2006	Luz y Vida — Núm. 7 — Diciembre 2006
Luz y Vida — No. 7 — Presentation	Luz y Vida — Núm. 7 — Presentación
Orvonton and the Milky Way (second part)	Orvonton y la Vía Láctea (segunda parte)
A way to get closer to the consciousness of God	Un camino para acercarse a la conciencia de Dios
The adventure of living	La aventura de vivir
Where metaphysics fails completely	Allí donde la metafísica fracasa completamente
Praise God	Loa a Dios
Luz y Vida — No. 8 — February 2007	Luz y Vida — Núm. 8 — Febrero 2007
Luz y Vida — No. 8 — Presentation	Luz y Vida — Núm. 8 — Presentación
Orvonton and the Milky Way (part three)	Orvonton y la Vía Láctea (tercera parte)
Path of Paradise	Camino del Paraíso
What mansion world are we going to?	¿A qué mundo mansión vamos?
Luz y Vida — No. 9 — May 2007	Luz y Vida — Núm. 9 — Mayo 2007
Luz y Vida — No. 9 — Presentation	Luz y Vida — Núm. 9 — Presentación
Urantia present, spectacular and enviable?	Presente de Urantia, ¿espectacular y envidiable?
Future of Urantia according to the UB	Futuro de Urantia según el LU
Eden project	Proyecto Edén
Luz y Vida — No. 10 — September 2007	Luz y Vida — Núm. 10 — Septiembre 2007
Luz y Vida — No. 10 — Presentation	Luz y Vida — Núm. 10 — Presentación
Jerusem circles	Los círculos de Jerusem
Live a new life	Vivir una nueva vida
The star of Bethlehem	La estrella de Belén
Communications between worlds	Comunicaciones entre mundos
Luz y Vida — No. 11 — December 2007	Luz y Vida — Núm. 11 — Diciembre 2007
Luz y Vida — No. 11 — Presentation	Luz y Vida — Núm. 11 — Presentación
Holy places? (first part)	¿Lugares Santos? (primera parte)
How many survive?	¿Cuántos sobreviven?
News about the UAI International Conference and Spain Association	Noticias sobre la Conferencia Internacional 2009 y la Asociación Urantia de España
Luz y Vida — No. 12 — February 2007	Luz y Vida — Núm. 12 — Febrero 2008
Luz y Vida — No. 12 — Presentation	Luz y Vida — Núm. 12 — Presentación
Holy places? (second part)	¿Lugares Santos? (segunda parte)
What is expected of us?	¿Qué se espera de nosotros?
More about how many survive (part one)	Más sobre cuántos sobreviven (primera parte)
News about the UAI International Conference	Noticias sobre la Conferencia Internacional UAI
Luz y Vida — No. 13 — May 2008	Luz y Vida — Núm. 13 — Mayo 2008
Luz y Vida — No. 13 — Presentation	Luz y Vida — Núm. 13 — Presentación
More about how many survive (second part)	Más sobre cuántos sobreviven (segunda parte)
Poem to the Adjuster	Poema al Ajustador
VIII Meeting of Readers of the Urantia Book in Spain	VIII Encuentro de Lectores del Libro de Urantia en España
News about the 2009 UAI International Conference	Noticias sobre la Conferencia Internacional AUI 2009
Luz y Vida — No. 14 — September 2008	Luz y Vida — Núm. 14 — Septiembre 2008
Luz y Vida — No. 14 — Presentation	Luz y Vida — Núm. 14 — Presentación
Causes and effects	Causas y efectos
Prayer for every night	Oración para todas las noches
Do all mortals survive?	¿Sobreviven todos los mortales?
More about how many survive (last part)	Más sobre cuántos sobreviven (última parte)
Transcendence	Trascendencia
News from Urantia Association of Spain	Noticias de la Asociación Urantia de España
Luz y Vida — No. 15 — December 2008	Luz y Vida — Núm. 15 — Diciembre 2008
Luz y Vida — No. 15 — Presentation	Luz y Vida — Núm. 15 — Presentación
Jesus and the Samaritan woman	Jesús y la samaritana
Adjuster and experience	El Ajustador y la experiencia
The Urantia Book and its dissemination	El Libro de Urantia y su difusión
News from Urantia Association of Spain	Noticias de la Asociación Urantia de España
Luz y Vida — No. 16 — February 2009	Luz y Vida — Núm. 16 — Febrero 2009
Luz y Vida — No. 16 — Presentation	Luz y Vida — Núm. 16 — Presentación
The mind according to revelation (second part)	La mente según la revelación (segunda parte)
There is always a beginning	Siempre hay un comienzo
The Alchemy of Creation	La Alquimia de la Creación
News from Urantia Association of Spain	Noticias de la Asociación Urantia de España
Luz y Vida — No. 17 — May 2009	Luz y Vida — Núm. 17 — Mayo 2009
Luz y Vida — No. 17 — Presentation	Luz y Vida — Núm. 17 — Presentación
Genesis of the International Conference	Génesis de la Conferencia Internacional
Highlights of the International Conference	Lo más destacado de la Conferencia Internacional
Luz y Vida — No. 18 — September 2009	Luz y Vida — Núm. 18 — Septiembre 2009
Luz y Vida — No. 18 — Presentation	Luz y Vida — Núm. 18 — Presentación
The mind according to revelation (last part)	La mente según la revelación (última parte)
The unmanifested	Lo no manifestado
How many mortals survive	Cuántos mortales sobreviven
The four candles	Las cuatro velas
News from Urantia Association of Spain	Noticias de la Asociación Urantia de España