Index of ANZURA “The Arena” articles	Índice de los artículos de «The Arena» de ANZURA
2019	2019
The Arena – Summer 2019	The Arena – Verano 2019
The Arena – Summer 2019 — Newsletter	The Arena – Verano 2019 — Boletín
President’s Report – December 2019	Informe del Presidente - Diciembre de 2019
Annual Conference Auckland New Zealand 2020	Conferencia Anual Auckland Nueva Zelanda 2020
Canberra 2019 Conference Report	Informe de la conferencia Canberra 2019
Growing the Supreme	Haciendo crecer lo Supremo
Mind Over Matter – Spirit Over Mind	La mente sobre la materia, el espíritu sobre la mente
As the Spirit Moves You	Como el Espíritu te mueve
The Ascension Plan	El Plan de la Ascensión
New Zealand Corner – Summer 2019	Rincón de Nueva Zelanda – Verano 2019
The Inner World of Mankind	El mundo interior de la humanidad
River of Life	Río de la Vida
The Arena – Autumn 2019	The Arena – Otoño 2019
The Arena – Autumn 2019 — Newsletter	The Arena – Otoño 2019 — Boletín
President Report – Autumn 2019	Informe del Presidente - Otoño de 2019
ANZURA’s Conference Canberra 2019	Conferencia de ANZURA Canberra 2019
2019 National Study Day	Día Nacional del Estudio 2019
On the Cosmic Background	Sobre el trasfondo cósmico
Living the Ascension Plan in Terrestrial Human Experience	Viviendo el Plan de Ascensión en la Experiencia Humana Terrestre
New Zealand Corner – Autumn 2019	El rincón de Nueva Zelanda – Otoño 2019
Urantia Towards Light & Life	Urantia hacia la luz y la vida
Poem by Leith	Poema de Leith
The Arena – Winter 2019	The Arena – Invierno 2019
The Arena – Winter 2019 — Newsletter	The Arena – Invierno 2019 — Boletín
President Report – Winter 2019	Informe del Presidente - Invierno de 2019
Conference Reminder – Time to Register!	Recordatorio de la conferencia: ¡es hora de registrarse!
Study Day 2019 – Reflections	Día de Estudio 2019 – Reflexiones
New Zealand Corner – Winter 2019	El rincón de Nueva Zelanda – Invierno 2019
Farewell Mark Bloomfield	Adiós Mark Bloomfield
Our Educational Imperative – A Strategy for the Coming Decades	Nuestro imperativo educativo: una estrategia para las próximas décadas
Proclaiming the Gospel with Power in the 21st Century	Proclamando el Evangelio con poder en el siglo XXI
A New Approach to Revelation	Un nuevo enfoque de la revelación
Conference 2004 Preamble – Echoes of Eden	Preámbulo de la Conferencia 2004 – Ecos del Edén
Existentialism in Australia and New Zealand	Existencialismo en Australia y Nueva Zelanda
Shaking Hands – a Poem	Dar la mano - un poema
2020	2020
The Arena – Spring 2020	The Arena – Primavera 2020
The Arena – Spring 2020 — Newsletter	The Arena – Primavera 2020 — Boletín
President’s Report – Spring 2020	Informe del Presidente - Primavera de 2020
Virtual ANZURA Annual Conference 2020	Conferencia Anual Virtual ANZURA 2020
The Parable of the Sower	La parábola del sembrador
Where are the Daughters of God?	¿Dónde están las Hijas de Dios?
Editor’s Notebook	Cuaderno del editor
The Temple Deep Clean	La limpieza a fondo del templo
Creative Imagination in Prayer and Worship	Imaginación creativa en la oración y la adoración
Are You Lonesome Tonight?	¿Estás solo esta noche?
Business on Urantia	Negocios en Urantia
August 21 – a Poem	21 de agosto – un poema
The Stillness – a Poem	La quietud – un poema
The Arena – Summer 2020	The Arena – Verano 2020
The Arena – Summer 2020 — Newsletter	The Arena – Verano 2020 — Boletín
President’s Report – Summer 2020	Informe del Presidente - Verano de 2020
Language Matters	El idioma importa
Post Covid 19 Spirituality	Espiritualidad Post Covid 19
A Bit of History	Un poco de historia
Ancient Orvonton, and a Young Cosmic Web	El antiguo Orvonton y una joven red cósmica
Universal Ethics – Concepts from The Urantia Book	Ética universal: conceptos del libro de Urantia
Think Alike – Necessary or Unnecessary?	Pensar igual: ¿necesario o innecesario?
The Mind Arena of Choice	El campo mental de elección
Amarantos	Amarantos
The Arena – Autumn 2020	The Arena – Otoño 2020
The Arena – Autumn 2020 — Newsletter	The Arena – Otoño 2020 — Boletín
President’s Report – Autumn 2020	Informe del Presidente - Otoño de 2020
Virtual Study Groups and Conferences	Grupos de Estudio y Conferencias Virtuales
Workshop Summary: Spirit in Society, Overcoming Resistance	Resumen del taller: Espíritu en la sociedad, superación de resistencias
Other and Higher Frames	Otros y superiores marcos
Disease and Immunity in Relation to the Urantia Book	Enfermedad e inmunidad en relación con el libro de Urantia
Fear Not	No temas
New Zealand Corner – Autumn 2020	El rincón de Nueva Zelanda – Otoño 2020
The Apostle Matthew	El apóstol Mateo
2021	2021
The Arena – Summer 2021	The Arena – Verano 2021
The Arena – Summer 2021 — Newsletter	The Arena – Verano 2020 — Boletín
President’s Report – Summer 2021	Informe del presidente - Verano de 2021
2022 Anzura Annual Conference	Conferencia Anual de Anzura 2022
2021 ANZURA Virtual Conference Report	Informe de la conferencia virtual ANZURA 2021
We Are, Because I AM	Somos, porque YO SOY
The Stability of Goodness	La estabilidad del bien
Where Are They All?	¿Dónde están todos?
Video Part 4D: Ancient Orvonton, and a Young Cosmic Web	Vídeo Parte 4D: El antiguo Orvonton y una joven red cósmica
The Tree of Life – Myth or Fact	El árbol de la vida: mito o realidad
The Arena – Winter 2021	The Arena – Invierno 2021
The Arena – Winter 2021 — Newsletter	The Arena – Invierno 2021 — Boletín
President’s Report – Winter 2021	Informe del presidente: invierno de 2021
Sydney Conference Reminder – 2021	Recordatorio de la conferencia de Sídney - 2021
Study Day 2021 – Reflections	Día de Estudio 2021 – Reflexiones
Mining the Archives	Exploración de los archivos
Application of Scientific Thinking…	Aplicación del pensamiento científico...
Recent Developments in the Astrophysics Sector	Desarrollos recientes en el sector de la astrofísica
The Challenges of Diversity	Los desafíos de la diversidad
True Success	El verdadero éxito
New Zealand Corner	El rincón de Nueva Zelanda
2022	2022
The Arena – Summer 2022	The Arena – Verano 2022
The Arena – Summer 2022 — Newsletter	El verdadero éxito
President’s Report – Summer 2022	Informe del presidente - Verano de 2022
2023 Annual Conference in Sydney	Conferencia Anual 2023 en Sydney
2022 ANZURA Annual Conference Report	Informe de la Conferencia Anual de ANZURA 2022
Walking the R.O.P.E – An Invitation to Intimacy with God	Caminando sobre la CUERDA – Una invitación a la intimidad con Dios
The Religion of Jesus	La religión de Jesús
The Ultimate Human Experience	La experiencia humana definitiva
New Zealand Corner	El rincón de Nueva Zelanda
The Arena – Winter 2022	The Arena – Invierno 2022
The Arena – Winter 2022 — Newsletter	The Arena – Invierno 2022 — Boletín
Presidents Report – Winter 2022	Informe de los presidentes: invierno de 2022
Countdown to Tassie Conference	Cuenta atrás para la conferencia de Tassie
National Study Day Reflections	Reflexiones del Día Nacional del Estudio
Urantia Book Presentation	Presentación del libro de Urantia
Reflections of Body, Mind and Psychic Expo	“Expo de las Reflexiones de Cuerpo, Mente y Psíquico”
Doing According to the Urantia Papers	Actuar según los documentos de Urantia
2023	2023
The Arena – Winter 2023	The Arena – Invierno 2023
The Arena – Winter 2023 — Newsletter	The Arena – Invierno 2023 — Boletín
President’s Report – Winter 2023	Informe del presidente: invierno de 2023
2023 Annual Conference in Sydney Update	Actualización de la Conferencia Anual de 2023 en Sydney
Unity – Harmony Within Diversity of Experience and Belief	Unidad – Armonía dentro de la diversidad de experiencias y creencias
Feelings Too Deep for Words	Sentimientos demasiado profundos para expresarlos con palabras
Faith-Trust in the Goodness of God	Fe-Confianza en la Bondad de Dios
Spiritual Practices – an Invitation to Intimacy with God	Prácticas espirituales: una invitación a la intimidad con Dios
Activity Report from a Urantia Book Student	Informe de actividad de un estudiante de El libro de Urantia
On the Revelatory Status	Sobre el estatus revelador
New Zealand Corner	El rincón de Nueva Zelanda
Korean Readers’ Conference	Conferencia de lectores coreanos