Index of The Study Group Herald articles	Índice de artículos del «Study Group Herald»
Volume 1 — 1991	Volumen 1 — 1991
December 1991 — Vol. 1 No. 2	Diciembre 1991 — Vol. 1 No. 2
Issue Content, December 1991	The Study Group Herald - Contenido del número, diciembre de 1991
The Study Groups Around Oklahoma City	Los grupos de estudio en la ciudad de Oklahoma
Studies In Marriage, Home And Children	Estudios sobre el matrimonio, el hogar y los hijos
A Vision of Angels	Una visión de los ángeles
Mother Of My Soul...	Madre de mi alma...
A History of the Urantia Papers	Una historia de los documentos de Urantia
Lighten Life News	Noticias de Lighten Life
Facts from Urantia Files	Hechos de Expedientes Urantia
The Water of Astonishment	El agua del asombro
What Am I? Who Am I? An Introspection Of Myself	¿Qué soy? ¿Quién soy? Una introspección de mí mismo
Message to my soul	Mensaje a mi alma
Periodicals of the Movement	Publicaciones del Movimiento
On Deity and Gender	Sobre la deidad y el género
A Life for All Seasons	Una vida para todas las estaciones
Letters	Cartas
Classifieds	Clasificados
Bulletin Board	Tablero de anuncios
A Prayer for Community and Love	Una oración por la comunidad y el amor
God's Love and His Law	El amor de Dios y su ley
Volume 2 — 1992	Volumen 2 — 1992
December 1992 — Vol. 2 No. 3	Diciembre 1992 — Vol. 2 No. 3
Issue Content, December 1992	The Study Group Herald - Contenido del número, diciembre de 1992
Children In The Urantia Movement	Niños en el movimiento Urantia
Excerpts from the letters	Extractos de las cartas
20 20 20	20 20 20
Family Rituals And Celebrations	Rituales y celebraciones familiares
Urantia Nuptials	Nupcias Urantia
Fatherhood: Jesus As A Creative Parental Role Model	Paternidad: Jesús como modelo paternal creativo
Studies For Troubled Times	Estudios para tiempos convulsos
Ascending Currents	Corrientes ascendentes
An Interview with Clyde Bedell. Reminiscences Of An Early Forum Member	Una entrevista con Clyde Bedell. Reminiscencias de uno de los primeros miembros del foro
Facts from Urantia Files	Hechos de Expedientes Urantia
The Irish Study Group	El grupo de estudio irlandés
Letters	Cartas
Universal Love Father — A Poem, A Song	Padre de amor universal: un poema, una canción
The Soul As The Entrance Into True Community	El alma como entrada a la verdadera comunidad
Letters	Cartas
Classifieds	Clasificados
Bulletin Board	Tablero de anuncios
1992 Calendar Of Events	Calendario de eventos de 1992
Achieving Balance	Lograr el equilibrio
Touch the World	Toca el mundo
From The Editor	Del editor
Volume 3 — 1993	Volumen 3 — 1993
August 1993 — Vol. 3 No. 4	Agosto 1993 — Vol. 3 No. 4
Issue Content, August 1993	The Study Group Herald - Contenido del número, agosto de 1993
To Share with Other Readers	Para compartir con otros lectores
A Letter from New York State	Una carta desde el estado de Nueva York
Childhood Days at the Forum	Días de la Infancia en el Foro
Ask and You Shal Receive	Pide y recibirás
Caring for an Aging Parent	Cuidando a un padre anciano
A Memorial of a very Special Nature	Un Memorial de carácter muy especial
An Experience with My Dad in a Nursing Home 	Una experiencia con mi padre en un asilo de ancianos
Letters	Cartas
Motaquest	Motaquest
The Life and Times of Jesus	La vida y los tiempos de Jesús
Jesus and Jude in Jerusalem Jail	Jesús y Judas en la cárcel de Jerusalén
Ascending Currents	Corrientes ascendentes
Florida Students of The Urantia Book	Estudiantes de Florida del libro de Urantia
Letters	Cartas
Classifieds	Clasificados
Bulletin Board	Tablero de anuncios
Calendar	Calendario
From The Editor	Del editor
Volume 4 — 1994	Volumen 4 — 1994
Fall 1994 — Vol. 4 No. 5	Otoño 1994 — Vol. 4 No. 5
Issue Content, Fall 1994	The Study Group Herald - Contenido del número, otoño de 1994
Initial Thoughts	Pensamientos iniciales
In Memoriam	En memoria
Who and How?	¿Quién y cómo?
Letters To The Herald	Cartas al Herald
Bulletin Board	Tablero de anuncios
International Letters	Cartas Internacionales
The Melchizedek Bestowal 	El otorgamiento de Melquisedec
Regarding Instructions or Mandates 	Sobre Instrucciones o Mandatos
For Teens, It's A Different World	Para los adolescentes, es un mundo diferente
Who Says Day Care Can't Be Fun?	¿Quién dice que la guardería no puede ser divertida?
The Burden of the Basket	La carga de la canasta
Divorce: To Do or Not To Do?	Divorcio: ¿Divorciarse o no divorciarse?
Men and Women in Partnership	Hombres y mujeres en colaboración
Abortion and The Urantia Book	El aborto y el libro de Urantia
Family Life Values Survey	Encuesta sobre valores de la vida familiar
Planetary Government of Urantia Additional Definitions and References	Definiciones y referencias adicionales del Gobierno Planetario de Urantia
Study Groups of Arizona	Grupos de estudio de Arizona
The Urantia Book at the Parliament of World's Religions	El Libro de Urantia en el Parlamento de las Religiones del Mundo
Enjoying the Spectacle of the Parliament	Disfrutando del espectáculo del Parlamento
The Grapevine	La vid
Classifieds	Clasificados
Ascending Currents	Corrientes ascendentes
Volume 6 — 1996	Volumen 6 — 1996
Spring/Summer 1996 — Vol. 6 No. 7	Verano 1996 — Vol. 6 No. 7
Issue Content, Spring/Summer 1996	The Study Group Herald - Contenido del número, verano de 1996
Letters To The Fellowship	Cartas a la comunidad
General Council Meets in San Francisco	El Consejo General se reúne en San Francisco
Get Ready for IC '96	Prepárese para IC '96
Dateline	Fecha límite
Little UrantiaL	Pequeño UrantiaL
Dare to Risk	Atrévete a arriesgarte
The Science of Fatherhood	La ciencia de la paternidad
IC'96	IC'96
Graduation of Ruth E. Renn	Graduación de Ruth E. Renn
Calendar	Calendario
Winter 1996 — Vol. 6 No. 8	Winter 1996 — Vol. 6 No. 8
Issue Content, Winter 1996	The Study Group Herald - Contenido del número, invierno de 1996
Welcome to the New Study Group Herald	Bienvenidos al Nuevo Study Group Herald
Letters to the Fellowship	Cartas a la Fellowship
International Letters	Cartas Internacionales
A Place Apart	Un lugar aparte
Defining Spiritual Service 	Definición del Servicio Espiritual
Reaching Out in Faith	Alcanzando la fe
Last of Founding Trustees Passes Away	Fallece el último de los fideicomisarios fundadores
Gearing Up for IC 96	Preparándose para IC 96
Jesus — The Man, The Hero	Jesús: el hombre, el héroe
A Hero For All	Un héroe para todos
Two Prayer Poems	Dos poemas de oración
Dateline	Fecha límite
2,000th Birthday Party	Fiesta de cumpleaños número 2000
In Close Proximity — The World of the Nonbreathers	En estrecha proximidad: el mundo de los que no respiran
What Does Urantia Mean?	¿Qué significa Urantia?
Study Groups of Tennessee	Grupos de estudio de Tennessee
Divine Nature	Naturaleza Divina
Calendar	Calendario
Volume 7 — 1997	Volumen 7 — 1997
Winter 1997 — Vol. 6 No. 9	Invierno 1997 — Vol. 6 No. 9
Issue Content, Winter 1997	The Study Group Herald - Contenido del número, invierno de 1997
Letters	Cartas
IC 96 Coverage	Cobertura IC 96
The Cosmic Family	La familia cósmica
Study Group Directory	Directorio de grupos de estudio
Faith Makes All Things Possible & Love Makes Them Beautiful	La fe hace todas las cosas posibles y el amor las hace hermosas
We're All Connected	Estamos todos conectados
The Urantia Book in Lithuania	El libro de Urantia en Lituania
IC 96 Photo Essay	Ensayo fotográfico IC 96
1997 Summer Seminar To Meet in Vancouver July 10-13	El seminario de verano de 1997 se celebrará en Vancouver del 10 al 13 de julio
Three Rs: Relationship, Religion and Revelation	Tres R: Relación, Religión y Revelación
Dateline	Fecha límite
News from Colombia	Noticias de Colombia
President's Report to the General Council	Informe del Presidente al Consejo General
The Fellowship Is Now On The WWW	La comunidad ya está en la WWW
Calendar Of Events	Calendario de eventos