Index of The Study Group Herald articles	https://ubhs.hosted-by-files.com/http/FrameDocTypesBY.html	is-title	The Study Group Herald
Volume 1 — 1991	---	is-volume	---
December 1991 — Vol. 1 No. 2	/image/article/Study_Group_Herald/1991_12.jpg	is-issue	---
Issue Content, December 1991	/en/article/Study_Group_Herald/Issue_Content_1991_12	---	Spiritual Fellowship
The Study Groups Around Oklahoma City	/en/article/David_Glass/The_Study_Groups_Around_Oklahoma_City	David Glass	Study Group Herald
Studies In Marriage, Home And Children	/en/article/Annette_Crawford/Studies_In_Marriage_Home_And_Children	Annette Crawford	Study Group Herald, Family
A Vision of Angels	/en/article/Art_Gregory/A_Vision_of_Angels	Art Gregory	Study Group Herald
Mother Of My Soul...	/en/article/Annette_Crawford/Mother_Of_My_Soul	Annette Crawford	Study Group Herald
A History of the Urantia Papers	/en/article/Mark_Kulieke/A_History_of_the_Urantia_Papers	Mark Kulieke	Study Group Herald
Lighten Life News	/en/article/Study_Group_Herald/Lighten_Life_News_01	---	Study Group Herald
Facts from Urantia Files	/en/article/Allen_Collins/Facts_from_Urantia_Files	Allen Collins	Study Group Herald
The Water of Astonishment	/en/article/Wayne_Ferrier/The_Water_of_Astonishment	Wayne Ferrier	Study Group Herald
What Am I? Who Am I? An Introspection Of Myself	/en/article/Michael_S_Smith/What_Am_I_Who_Am_I_An_Introspection_Of_Myself	Michael S. Smith	Study Group Herald
Message to my soul	/en/article/Chilufya_M_K_Thompson/Message_to_my_soul	Chilufya M.K. Thompson	Study Group Herald
Periodicals of the Movement	/en/article/Cece_Forrester/Periodicals_of_the_Movement	Cece Forrester	Study Group Herald
On Deity and Gender	/en/article/Mary_Daly/On_Deity_and_Gender	Mary Daly	Study Group Herald
A Life for All Seasons	/en/article/Annie_Spiars/A_Life_for_All_Seasons	Annie_Spiars	Study Group Herald
Letters	/en/article/Study_Group_Herald/Letters	---	Study Group Herald
Classifieds	/en/article/Study_Group_Herald/Classifieds	---	Study Group Herald
Bulletin Board	/en/article/Study_Group_Herald/Bulletin_Board	---	Study Group Herald
A Prayer for Community and Love	/en/article/Stephen_Zendt/A_Prayer_for_Community_and_Love	Stephen Zendt	Study Group Herald
God's Love and His Law	/en/article/Annette_Crawford/Gods_Love_and_His_Law	Annette Crawford	Study Group Herald